ど	土	止	戸	努	孥	駑	取	録	留	℃	°	奴	堵	度	呶	退	怒	弩	何
で	出	弟
づ	連	積	図	詰	津	漬	付	突
ぢ	持	痔	地
だ	騨	田	澑	兌	建	懦	惰	出	駝	墮	陀	朶	妥	溜	鴕	柁	儺	立	沱	雫	拏	唾	駄	陏	楕	蛇	娜	打	拿	荼	堕	佗	橢	舵	抱
どん	嫩	呑	丼	曇	緞	貪	鈍
どろ	泥	土呂
どる	＄
どり	取り
どら	鐃	銅鑼	錚	鑼
どよ	響	響動
ども	土盛	共	吃
どめ	度目
どま	土間
どぶ	溝
どひ	土肥	奴婢
どば	駑馬	土場
どの	何の	殿
どな	怒鳴
どて	塢	土堤	土手
どつ	肭
どこ	何処
どく	讀	髑	独	徳	獨	毒	読
どき	怒気	土器	度器	時
どお	通	遠
どう	藤	鐃	童	堂	通	獰	銅	如何	撓	〃	艟	洞	恫	動	撞	耨	陶	儂	Copper	々	橈	嫐	ゞ	憧	Cu	瞠	瞳	導	桐	同	鬧	慟	萄	道	働	胴	僮
どい	土井	土居	土肥
どあ	度合
でん	田	澱	棯	淀	畋	沺	傳	黏	伝	甸	臀	殿	佃	鈿	電
でわ	出葉	出羽
でる	出る
でら	寺
でゆ	出湯
でめ	出目
でむ	出向
でま	手間
でば	出場	出歯	出刃
でつ	出尽	捏
でだ	出出
でた	出た	出立
でぞ	出初
です	出過
でし	弟子	deci
でこ	凸
でく	出喰	木偶	出食
でぎ	出切
でき	溺	出来
でか	出掛	デカ	deca	刑事	出来
でい	禰	泥	出入
であ	出逢	出合	出会
づれ	連れ
づら	辛
づよ	強
づめ	詰	詰め
づみ	詰み
づま	妻
づた	伝
づけ	漬け	漬	付	付け
づく	造	尽	做	作
づき	付
づか	遣	塚	使	冢
ぢみ	地味
ぢば	地場
ぢげ	地下
ぢか	直	近
だん	騨	椴	斷	旦	灘	談	檀	彈	弾	男	団	壇	暖	團	煖	断	段
だれ	誰
だる	怠	懶
だよ	便
だめ	駄目
だま	默	玉	騙	黙
だほ	拿捕
だぶ	ダブ
だび	荼毘
だば	駄馬
だは	打破
だに	壁蝨	谷
だな	棚
だて	立て	点	舘	館	建て	伊達
だつ	奪	妲	怛	脱	獺
だっ	抱っ	脱
だち	逹	達	立ち
だだ	駄々
だし	出汁	山車
ださ	打差
だけ	嶽	岳
だく	濁	諾	駄句
だき	唾棄	舵機	惰気
だか	高
だお	倒
だい	内	戴	梯	餒	臺	第	岱	弟	迺	大	廼	題	台	醍	代
だい#	第
どんま	鈍磨	鈍麻
どんと	呑吐
どんす	緞子
どんき	鈍器
どんか	鈍化
どわす	度忘
どろよ	泥除
どろた	泥田
どろえ	泥絵
どれい	奴隷	土鈴
どるい	土塁	土類
どよう	土曜	土用
どもん	土門
どもり	土盛り	度盛り
どみん	土民
どまり	止まり
どぼく	奴僕	土木
どべい	土塀
どへき	土壁
どぶろ	土風炉
どふん	土墳
どびん	土瓶
どばと	土鳩
どばし	土橋
どはつ	怒髪
どのう	土嚢
どにち	土日
どなり	隣	鄰
どなべ	土鍋
どなた	何方
どどめ	土留め
どとう	怒涛	怒濤
どてら	褞袍
どっぽ	独歩
どっち	何方
どっこ	独鈷
どっけ	毒気
どっき	毒気
どっか	読過
どちら	何方
どだん	土壇
どだい	土台	土代
どぞく	土俗
どぞう	土蔵
どそく	土足
どそう	土葬	土倉
どせき	土石
どせい	怒声	土星	土製
どすう	度数
どじん	土人
どしゃ	土砂
どしつ	怒叱	土質
どさん	土讃
どごう	土豪	怒号
どこら	何処ら
どこう	土工	土光	土侯
どげざ	土下座
どけん	土建
どけい	時計
どぐう	土偶
どくわ	独和	独話
どくろ	髑髏
どくや	毒矢
どくみ	毒見
どくふ	毒婦
どくは	読破
どくづ	毒突
どくそ	毒素
どくず	読図
どくじ	独自
どくし	毒死
どくご	独語	読後
どくけ	毒消	毒気
どくが	毒牙	毒蛾
どくい	毒入
どぎも	度肝
どきん	土禁
どがい	度外
どかん	土管
どかた	土方
どかい	土塊
どおり	通	通り
どおし	同士
どうわ	同和	道話	童話
どうろ	道路
どうり	道理
どうら	銅鑼
どうや	銅谷	同夜
どうま	胴間
どうぼ	同母
どうふ	豆腐	同歩
どうひ	胴皮	同飛
どうば	同馬
どうは	導波	道破
どうと	道都
どうち	≡	同治	同値	同地	⇔
どうそ	同素
どうず	同図
どうじ	同時	同次	童子	動時	同字	胴締
どうし	同誌	同士	道志	同志	同視	同市	動詞	道士	同氏	同旨	導師
どうざ	同座	動座
どうさ	同左	動作
どうご	道後	同語
どうこ	銅壺
どうけ	道家	道化	同家
どうぐ	道具
どうく	同区
どうぎ	同義	道着	道義	道議	動議	胴着
どうき	同気	銅器	同期	動機	動悸	動気	同機
どうが	童画	動画
どうか	銅貨	同化	道家	同課	道歌	導火
どうう	堂宇
どうい	胴衣	同位	同意
どうあ	胴上
どいつ	獨乙	獨逸	独	独逸	独乙	何奴
どあほ	ど阿呆
どあつ	土圧
どあい	度合	度合い
でんわ	電話
でんろ	電路
でんり	電離
でんや	田野
でんぽ	田圃
でんぷ	田夫
でんぶ	臀部	田麩
でんぱ	電波	伝播
でんば	電場
でんち	電池
でんだ	伝田
でんじ	電磁
でんし	電子
でんぎ	電技
でんき	電機	伝奇	電器	電気	傳綺	伝記
でんか	伝家	電荷	殿下	電化	田家
でんい	電位
でるた	δ	Δ
でよう	出様
でやす	出易
でもん	出門
でもの	出物
でもど	出戻
でもと	出本
でむら	出村
でむか	出迎
でみせ	出店
でみず	出水
でまわ	出回
でまる	出丸
でまど	出窓
でまち	出待ち	出町
でまか	出任
でまえ	出前
でぶち	出淵
でふね	出船
でばん	出番
でばら	出払
でばな	出鼻	出端
ではら	出払
ではじ	出始
ではい	出入
でにく	出難
でなお	出直
でてゆ	出て行
でてこ	出て来
でてく	出て来
でてき	出て来
でづら	出面
でつづ	出続
でつく	出尽
でっぱ	出張	出っ歯	出っ張
でっち	丁稚
でだま	出玉
でだし	出出し	出だし
でたに	出谷
でたて	出立て
でぞめ	出初め
でそろ	出揃
でせん	出銭
ですぎ	出過ぎ
でじろ	出城
でじる	出汁
でじま	出島
でしお	出汐	出潮
でしい	弟子入
でざわ	出沢
でざき	出崎
でさき	出先
でぐち	出口
でぎわ	出際
できば	出来映	出来栄
できね	出来値
できな	出来無
できす	出来過
できし	溺死
できあ	出来上
でがわ	出川
でかた	出方	出かた
でかせ	出稼
でかけ	出掛け
でおく	出遅
でいり	出入り
でいど	泥土
である	出歩
であし	出足
であい	出会い	出合い
づのう	頭腦
づつう	頭痛
づくり	作り
づくし	尽し	尽くし
づくえ	机
づかい	使い
ぢゅう	中
ぢもと	地元
ぢめん	地面
ぢみち	地道
ぢばく	地縛
ぢどり	地鶏
ぢとり	地鶏
ぢだい	地代
ぢぞく	持続
ぢしん	地震
ぢざけ	地酒
ぢさん	持参
ぢごく	地獄
ぢぐち	地口
ぢくぢ	忸怩
ぢあけ	地上げ
だんわ	談話
だんろ	暖炉	煖炉	煖爐
だんめ	段目
だんな	旦那
だんど	段取
だんと	檀徒	段取
だんづ	段付
だんち	団地	暖地
だんだ	段田
だんじ	男児
だんし	断嘴	弾指	男子	弾糸	檀紙	談志	弾子
だんさ	段差
だんご	団子
だんこ	断固	断乎
だんぐ	段組
だんく	段組
だんぎ	談義	談議
だんき	暖気	団旗	暖機	断機
だんか	檀家
だんう	弾雨
だんい	段位
だれか	誰か
だるま	達磨
だりん	舵輪
だりつ	打率
だらに	陀羅尼
だらく	堕落
だもの	駄物
だめづ	駄目詰
だめお	駄目押
だみん	惰眠
だぼら	駄法螺
だぼく	打撲
だぼう	打棒	打忘
だほん	駄本
だほう	打法
だべん	駄弁
だぶん	駄文
だぶつ	陀仏
だふや	だふ屋	ダフ屋
だひつ	惰筆
だはく	打拍
だとう	妥当	打倒
だでん	打電
だてん	打点
だつり	脱離
だつじ	脱字
だつご	脱誤
だつい	脱衣
だっぴ	脱皮
だっと	脱兎
だっそ	脱疽
だっし	脱脂
だっこ	抱っこ
だっき	妲己
だっか	脱化
だちん	駄賃
だたい	堕胎
だそく	蛇足
だせん	打線
だせき	打席
だせい	打製	惰性
だすう	打数
だしん	打診
だしゅ	舵手
だしゃ	打者
だしぬ	出し抜
だしき	出し切
だしお	出し惜
だしい	出し入
だしあ	出し合
だざい	太宰	堕罪
ださん	打算
ださく	駄作
だこく	打刻
だこう	蛇行
だげん	打弦
だげき	打撃
だけん	駄犬	打鍵
だけつ	妥結
だくひ	諾否
だくい	諾意
だきよ	抱き寄
だきに	荼枳尼
だきと	抱き取	抱き留
だきつ	抱き付
だきし	抱き締
だきこ	抱き込
だきお	抱き下
だきあ	抱き上	抱き合
だがし	駄菓子
だかん	兌換	打感	朶翰	蛇管
だかつ	蛇蠍	蛇蝎
だかい	打開
だおれ	倒れ
だえん	橢円	橢圓	楕円
だえき	唾液
だうん	朶雲
だいわ	大和
だいり	代理	大理	大利	内裏
だいら	平
だいや	◆	◇	大谷
だいめ	台目	代目
だいま	大間
だいぼ	代母
だいぶ	大夫	大分	大部
だいふ	代父
だいび	代引
だいひ	大悲
だいば	台場
だいの	大の
だいに	第二	第２	第2	大弐
だいな	台無
だいと	大都
だいち	代置	大値	代地	大地	台地
だいだ	代打
だいた	台田	代田
だいず	大豆
だいす	大好	台子
だいじ	大事	題字	大治	大寺	題辞	大字	大弐	大慈
だいし	台詞	題詞	大志	大師	題詩	大姉	台紙	第四
だいざ	台座
だいさ	大佐
だいご	第五	大吾	大子	大悟	醍醐	第５
だいく	第九	大工
だいぎ	代議
だいき	代機	大機	乃毅
だいか	代価	台下
だいい	代位	大尉	題意
どんるい	丼類
どんらん	貪婪	曇鸞
どんよく	貪欲
どんもの	丼物
どんぶり	丼
どんぶつ	鈍物
どんとう	鈍刀
どんてん	曇天
どんつう	鈍痛
どんぞこ	どん底
どんそく	鈍足
どんじり	どん尻
どんさい	鈍才
どんこん	鈍根
どんこう	鈍行
どんぐり	團栗	団栗
どんくさ	鈍臭
どんかん	鈍感
どんかく	鈍角
どわすれ	ど忘れ	度忘れ
どろんこ	泥んこ
どろよけ	泥除け
どろみち	泥道
どろみず	泥水
どろぼう	泥棒
どろぶね	泥舟
どろぬま	泥沼
どろなわ	泥縄
どろどろ	泥々
どろつち	泥土
どろくさ	泥臭
どろうみ	泥海
どるやす	ドル安
どるばこ	ドル箱
どるだて	ドル建て
どるだか	ドル高
どるがい	ドル買い
どるうり	ドル売り
どりょく	努力
どりょう	度量
どらわん	銅羅湾
どらやき	銅鑼焼
どらまか	ドラマ化
どらねこ	どら猫
どらごえ	どら声
どようび	土曜日
どやがい	どや街
どぶろく	濁酒	濁醪
どぶがわ	ドブ川	溝川
どぶがい	蚌
どぶいた	溝板
どひょう	土俵
どはずれ	度外れ
どなりつ	怒鳴り付
どなりち	怒鳴り散
どなりた	怒鳴り立
どなりこ	怒鳴り込
どなりあ	怒鳴り合
どどいつ	都々逸
どてみち	土手道
どてなべ	土手鍋
どてぐち	土手口
どっこう	独行
どっきょ	独居
どっかく	独覚
どっかい	読会	読解
どちょう	怒張
どちゅう	土中
どちゃく	土着
どたんば	土壇場
どすてば	土捨場
どすごえ	どす声
どすぐろ	どす黒	ドス黒
どじょう	泥鰌	土壤	鯲	鰌	鰍	土壌
どしょう	土性
どしゃぶ	土砂降
どしがた	度し難
どさんこ	道産子
どさけん	ドサ健
どこそこ	何処其処
どけんや	土建屋
どくりつ	独立
どくらく	独楽
どくやく	毒薬
どくむし	毒虫
どくぼう	独房
どくほん	読本
どくへび	毒蛇
どくぶん	独文
どくぶつ	毒物
どくひつ	毒筆
どくばり	毒針
どくはく	独白
どくはい	毒杯
どくぬき	毒抜き
どくどく	毒々
どくとく	独特	独得
どくだん	独断
どくだけ	毒茸
どくそん	独尊	独存	獨尊
どくそう	毒草	独奏	独走	独創
どくぜん	独善
どくぜつ	毒舌
どくせん	独占	毒腺	独擅
どくせき	毒螫
どくせい	毒性
どくじん	毒刃
どくじゅ	読誦
どくじゃ	毒蛇
どくしん	独身	読唇
どくしょ	読書
どくしゅ	毒酒	毒手
どくしゃ	読者
どくさつ	毒殺
どくさい	独裁
どくげん	独言
どくけし	毒消し
どくぐん	独軍
どくぎん	独吟
どくぎょ	毒魚
どくがん	独眼
どくがす	毒ガス
どくがし	毒菓子
どくがく	独学
どくがい	毒害
どくかい	読解
どくおう	独往
どくえん	独演
どくえさ	毒餌
どくえき	毒液
どくえい	独泳
どくいり	毒入り	毒入
どきょう	読経	度胸
どきゅう	弩級	土休
どきがわ	土器川
どがいし	度外視
どかゆき	ドカ雪	どか雪
どうわく	同枠
どうれん	道連
どうれつ	同列
どうるい	同類
どうりん	動輪
どうりつ	同率	道立
どうらん	胴乱	動乱	銅藍
どうらく	道楽
どうよう	同様	童謡	童幼	動揺
どうゆう	道有	同友	同憂
どうやく	同役
どうもん	同門	洞門
どうもと	堂本	胴元
どうもく	瞠目
どうもう	艟艨	獰猛	童蒙
どうめん	道面	道免
どうめい	同盟	同名
どうみん	道民
どうまん	道満
どうまわ	胴回
どうまる	胴丸
どうまき	胴巻
どうぼう	同房
どうほく	道北
どうほう	同胞	同袍	同朋	同報	同法
どうべや	同部屋
どうぶん	同文
どうぶつ	動物
どうぶち	胴縁
どうぶく	胴服
どうふく	同腹
どうふう	同封	同風
どうひつ	同筆
どうばん	銅板	銅盤	銅版
どうばち	銅鉢
どうはん	同伴
どうはろ	導波路
どうはち	銅鉢
どうはく	銅箔
どうはい	同輩
どうのじ	々
どうねん	同年	道念	動燃
どうにん	同人
どうなん	道南
どうなが	胴長
どうない	道内
どうどう	同道	道道	道々	堂々
どうとく	道徳
どうとう	道東	同等	同党	堂塔
どうでん	北海道電力	道傳	導電	道伝
どうてん	同点	動転	動顛	鬧天	動点
どうてき	動的
どうてい	同定	道程	童貞	同底
どうつう	導通
どうちじ	道知事
どうちく	同地区
どうだん	満天星	同段	道断	道斷	同断
どうだい	同題	同大
どうたく	銅鐸
どうたい	導体	動体	同体	動態	胴体
どうぞく	道俗	同族	同属
どうぞう	銅像
どうそん	同村	道村
どうそく	同側
どうそう	同相	同窓
どうぜん	同然	同前
どうぜい	同勢
どうせん	銅線	動線	同船	銅銭	導線
どうせき	同席	道関
どうせい	動静	同性	同声	同棲	道政	同姓	銅製
どうすう	同数
どうすい	導水
どうじん	同仁	道仁	同人
どうじょ	童女
どうじめ	胴締め
どうじま	堂島
どうじつ	同日
どうじし	同時枝
どうじく	同軸
どうじき	同時期
どうじか	同時化
どうしん	同心	道新	童心	道心
どうしょ	同書	同所
どうしゅ	同種	同株
どうしゃ	同車	動車	同社
どうして	如何して
どうしつ	同質	同室
どうした	堂下
どうしか	動詞化
どうざん	銅山
どうざい	同罪
どうさん	道産	動産	道三
どうさぶ	動作部
どうさつ	洞察
どうさじ	動作時
どうさか	動作可
どうさい	道斎
どうこん	同根	同梱
どうこく	同刻	慟哭	同国
どうこう	同好	道光	同興	瞳孔	銅鉱	同功	動向	同行	同校	道幸	同甲	同庚	同工
どうげん	道元	同源	道玄
どうげつ	同月
どうけん	洞見	同県	同権
どうけつ	洞穴
どうけし	道化師
どうけい	動径	同型	憧憬	同桂	同系	同形	同慶	道警
どうぐや	道具屋
どうぐち	洞口
どうぐだ	道具立
どうくん	同訓	同君
どうくつ	洞窟
どうぎん	同銀
どうぎご	同義語
どうきん	同金	同衾	同斤
どうきょ	同居
どうきづ	動機付
どうきじ	同記事
どうきき	同期機
どうがん	童顔	動眼
どうがた	同型
どうがく	道学	同学	同額
どうがい	道外
どうかん	同感	道灌	導管	道管	道観
どうかつ	恫喝
どうかく	動確	同角	同格
どうおん	同音
どうおう	道央
どうえん	導演
どうえき	同駅
どううら	胴裏
どういん	動因	動員	導引
どういつ	同一
どういご	同意語
どういぎ	同意義
どうあん	同案
どうあげ	胴上げ
どうあく	道悪
どうあい	同愛
どいなか	ド田舎	ど田舎
どいつご	ドイツ語
どいがき	土井垣
ど、にち	土、日
でんわや	電話屋
でんわき	電話機	電話器
でんれい	電鈴	伝令
でんりど	電離度
でんりく	電リク
でんらん	電纜
でんらい	伝来
でんめい	電命
でんぽん	伝本
でんぽう	伝法	電報
でんぼう	伝法
でんぷん	澱粉
でんぶん	伝文	電文	伝聞
でんぱん	伝搬	殿版	伝播
でんぱつ	電髪
でんぱち	伝八
でんぱた	田畑
でんぱし	電波子
でんばた	田畑
でんのう	電脳
でんねつ	電熱
でんどう	殿堂	伝道	電導	伝導	伝動	電動
でんとう	電燈	電灯	伝統
でんでん	電電	電々
でんてつ	電鉄
でんてい	電停
でんつう	電通
でんちく	電蓄
でんちぎ	電池切
でんだい	電大	田代
でんたん	電探
でんたつ	伝達
でんたく	電卓
でんそく	電束
でんそう	伝送	電送	電装
でんせん	伝線	電線	伝染	電専
でんせつ	伝説	電設
でんすけ	伝助	電助
でんじん	電人
でんじゅ	伝授
でんじば	電磁場
でんじは	電磁波
でんじき	電磁気
でんしん	伝信	田紳	電信
でんしょ	伝書
でんしゃ	田舎	電車	伝者
でんしは	電子波
でんしか	電子科	電子化
でんざい	電材
でんさん	電算	電産
でんごん	伝言
でんこう	電工	電光
でんげん	電源
でんげき	電撃
でんけん	電顕	電検
でんけい	電計
でんきろ	電気炉
でんきや	電気屋	電機屋	電器屋
でんきぶ	電気部
でんきき	電機器
でんきか	電気科	電気化
でんがく	田楽	電楽
でんかん	電管	電環
でんかご	電化後
でんかい	電界	電解
でんおん	伝音
でんえん	田園
でんいさ	電位差
でんあつ	電圧
でやしき	出屋敷
でもばん	デモ版
でもどり	出戻り
でもたい	デモ隊
でめとく	出目徳
でめきん	出目金
でむかえ	出迎え
でまかせ	出任せ
でぱちか	デパ地下
でばやし	出囃子
でばしょ	出場所
でばかめ	出歯亀
ではずれ	出外れ
ではじめ	出始め
ではいり	出入り
でなおし	出直し
でどころ	出処	出所
でづっぱ	出突っ張
でつぞう	捏造
でっぱな	出っ放
でっちり	出っ尻
でっちあ	でっち上	捏ち上
でたらめ	出鱈目
でしょく	出職
でしたち	弟子達
でしいり	弟子入り
でさかり	出盛り
でこぼこ	凸凹
でげいこ	出稽古
でぐあい	出具合
できわく	溺惑
できもの	出来物
できぼつ	溺没
できぼし	出来星
できばえ	出来栄え	出来映え
できだか	出来高
できたて	出来立て
できそこ	出来損
できすぎ	出来杉
できごと	出来事
できあい	出来合い	溺愛	出来合
でがたり	出語り
でかせぎ	出稼ぎ
でおんな	出女
でいねい	泥濘
でいたん	泥炭
でいすい	泥水	泥酔
ぢょうし	調子
ぢふぶき	地吹雪
ぢひびき	地響き
だんろん	談論
だんれつ	断裂
だんりん	檀林
だんらん	檀欒	団らん	団欒
だんらく	段落	談楽
だんゆう	男優
だんやく	弾薬	彈藥
だんもの	段物
だんめん	断面
だんめつ	断滅
だんみん	断眠
だんまく	彈幕	段幕	弾幕
だんぼう	暖房	煖房
だんぺん	断片
だんふみ	壇ふみ	檀ふみ
だんぴつ	断筆
だんびら	段平
だんぱん	談判
だんぱつ	断髪
だんばん	檀板
だんねん	断念
だんねつ	断熱
だんどり	段取り
だんどう	弾道	彈道
だんとつ	断トツ
だんとう	暖冬	弾頭	彈頭
だんてい	断定
だんちが	段違
だんだん	段々
だんたい	暖帯	弾帯	彈帶	団体
だんぞく	断続
だんそん	男尊
だんそう	断想	弾奏	男装	弾倉	断層
だんぜん	断然
だんぜつ	断絶
だんせん	断線
だんせい	弾性	男声	男性
だんすう	段数	弾数
だんすい	断水
だんじり	檀尻
だんじょ	男女
だんじて	断じて
だんじこ	談じ込
だんじく	段軸
だんじき	断食
だんしん	弾芯
だんしょ	壇所
だんしゅ	断種	檀主	断酒	断首
だんしゃ	檀車
だんしつ	煖室	暖室
だんしち	団七
だんざい	断罪
だんさい	断裁
だんごう	談合
だんこん	男根	弾痕
だんこう	団交	断交	断行
だんげん	断言	断弦
だんけつ	団結
だんけい	男系
だんぐみ	段組
だんくん	檀君
だんくみ	段組
だんぎれ	段切れ
だんぎり	段切り
だんきん	弾琴	断琴	断金
だんがん	弾丸	彈丸
だんがい	彈劾	断崖	弾劾
だんかん	断簡	段間
だんかい	段階	団塊
だんおつ	檀越
だんおち	檀越
だんうん	断雲
だんいん	団員
だんいた	段板
だんあん	断案
だんあつ	彈壓	弾圧
だれだれ	誰誰	誰々
だれそれ	誰某
だれかれ	誰彼
だれかば	誰カバ
だれあて	誰宛
だりょく	打力	惰力
だめだし	ダメ出し	駄目出し
だめおし	駄目押し	ダメ押し
だみごえ	ダミ声	濁声
だまりこ	黙り込
だましこ	騙し込
だましえ	騙し絵
だましう	騙し討
だてんし	堕天使
だてまき	伊達巻	伊達巻き
だてどの	伊達殿
だてしゃ	伊達者
だてがわ	伊達川
だてがた	伊達方
だつろう	脱牢	脱漏
だつりん	脱輪
だつらく	脱落
だつもう	脱毛
だつぼう	脱帽
だつぶん	脱文
だつぞく	脱俗
だつぜん	脱然
だつぜい	脱税
だつさら	脱サラ
だつごく	脱獄
だつえい	脱営
だっぽう	脱法
だっぷん	脱糞
だっぱん	脱藩
だっとう	脱刀	脱党
だったん	韃靼
だったい	奪胎	脱退
だっそう	脱走
だっせん	脱線
だっすい	脱水
だっしゅ	奪取
だっこく	脱穀
だっこう	脱肛	脱稿
だっかん	奪還
だっかく	奪格
だっかい	奪回	脱会
だちょう	鴕鳥	駝鳥
だだゆき	忠幸
だだっこ	駄々っ子
だじゅん	打順
だじゃれ	駄洒落
だじゃく	懦弱
だしもの	出し物
だしじる	出し汁
だししぶ	出し渋
だしがら	出し殻
だしかた	出し方
だしいれ	出し入れ
だざいふ	太宰府	大宰府
だけんじ	打鍵時
だくてん	濁点	゛
だくだく	諾々
だくせい	濁世
だくすい	濁水
だくしゅ	濁酒
だくおん	濁音
だぎょう	だ行	ダ行
だきょう	妥協
だきゅう	打球
だきすく	抱き竦
だきかか	抱き抱
だきおこ	抱き起
だきあわ	抱き合
だがっき	打楽器	駄楽器
だがしや	駄菓子屋
だえんこ	楕円弧
だいわん	大彎
だいわく	台枠
だいろく	第６	第六
だいれん	大連
だいりぼ	代理母
だいりき	大力
だいらく	大楽
だいよん	第四	第4	第４
だいよう	大葉	代用
だいやく	代役
だいもん	大問	代紋	大門	大紋
だいもつ	代物	大物
だいもく	題目
だいめい	題名	大明
だいまる	大丸
だいぼう	大坊
だいほん	台本
だいほう	大宝
だいべん	代弁	大便
だいへん	代返
だいぶん	大分
だいぶつ	大仏	代物
だいふだ	台札
だいふく	大福
だいびき	代引き	代引
だいひん	代品
だいひつ	代筆
だいばん	台盤
だいはち	大八
だいのじ	大の字
だいのう	大脳	代納
だいにん	大人	代任	代人
だいにぶ	第二部
だいにち	大日
だいにじ	第2次	第二次
だいにぎ	第二義
だいなん	大難
だいなり	＞
だいなな	第七
だいなし	台無	台無し
だいどく	大毒	代読
だいどう	大同	大道
だいとし	大都市
だいとく	大徳
だいとう	大盗	大唐	大東	大刀	大塔
だいてん	大篆	大典	題点
だいだい	代々	橙	大々
だいたん	大胆
だいたい	大腿	大隊	大体	代替
だいぞう	大蔵
だいそつ	大卒
だいそう	代奏	代走	体操
だいぜん	大膳
だいせん	大仙	大山
だいせつ	大雪
だいすけ	大介	大助	大祐	大輔	大亮
だいすき	大好き
だいすう	大数	台数	代数
だいじん	大尽	大神	大臣
だいじり	台尻
だいじゅ	大樹
だいじゃ	大蛇
だいじこ	大事故
だいしん	代診
だいしょ	代書
だいしゃ	代車	台車
だいざわ	代沢
だいざい	大罪	題材
だいさん	第III	第3	第三	代参	第３
だいさく	代作	大作
だいさい	大祭
だいごみ	醍醐味
だいごじ	醍醐寺
だいごし	第五子
だいごう	題号
だいごい	大語彙
だいこん	大根
だいこく	大黒
だいこう	代講	乃公	代行	大幸
だいげん	題言	代言
だいげき	大外記
だいけん	大検	大建
だいけつ	代決
だいけい	大計	大慶	台形	大型計算機センター	大型計算機	大計センター
だいぎん	大吟
だいぎし	代議士
だいきん	代金	大金
だいきら	大嫌
だいきぼ	大規模
だいきち	大吉
だいがん	大願
だいがす	大ガス
だいがく	大学	大學
だいがえ	代替
だいかん	大韓	大寒	代官
だいかつ	大喝
だいかこ	大過去
だいかく	大覚
だいかえ	代替
だいおん	大恩
だいおう	大黄	大王
だいえん	大円
だいえい	大栄	大映	大永
だいうん	大運
だいいん	代印	代員
だいいち	第１	第一	第1
だいいき	大域
だいあん	代案
どんりょく	嫩緑
どんよくさ	貪欲さ
どんづまり	どん詰り
どんちょう	緞帳	鈍重
どんじゅう	鈍重
どんしょく	貪食
どろぱっく	泥パック
どろぬまか	泥沼化
どろじあい	泥試合	泥仕合
どれいてき	奴隷的
どれいたち	奴隷達
どれいせん	奴隷船
どれいせい	奴隷制
どれいしゅ	奴隷主
どるそうば	ドル相場
どりょくか	努力家
どらむすこ	どら息子
どらむかん	ドラム缶
どらえもん	ドラえもん
どようばん	土曜晩
どまんなか	ド真中	ど真ん中
どぼくけい	土木系
どぼくがく	土木学
どぶねずみ	溝鼠
どぶにうむ	Db	Dubnium
どぶさらい	溝浚い
どびんむし	土瓶蒸	土瓶蒸し
どびょうし	銅拍子
どひょうば	土俵場
どにちげつ	土日月
どなりごえ	怒鳴り声
どてっぱら	土手っ腹
どっきょう	読経
どぞくてき	土俗的
どせいけい	土星系
どしろうと	ド素人	ど素人
どしゃぶり	土砂降り
どしゃくづ	土砂崩
どざえもん	土左衛門
どさまわり	どさ回り	ドサ回り
どこらへん	どこら辺
どくりょく	独力
どくりょう	読了
どくりつご	独立後	独立語
どくみょう	独明
どくだみか	Saururaceae	ドクダミ科
どくぜつか	毒舌家
どくせんか	独占化
どくじもじ	独自文字
どくじせい	独自性
どくしょか	読書家
どくしょう	独唱
どくしゅう	独修	独習
どくごかん	読後感
どくきのこ	毒茸	毒キノコ
どくあたり	毒中り
どうわちく	同和地区
どうわげき	童話劇
どうわくば	同枠馬
どうろわき	道路脇
どうろよこ	道路横
どうろもう	道路網
どうろほう	道路法
どうろはば	道路幅
どうろちず	道路地図
どうろだい	道路代
どうろぞく	道路族
どうろぞい	道路沿
どうろぜい	道路税
どうろせん	同路線
どうろがわ	道路側
どうれつし	同列視
どうりょく	動力
どうりょう	同僚	同量
どうりゅう	同流
どうように	同様に
どうゆうち	道有地
どうめだる	銅メダル
どうめいし	同名市	動名詞
どうみょう	同苗
どうみゃく	動脈
どうまわり	胴回り
どうまさつ	動摩擦
どうまごえ	胴間声
どうぼいん	同母音
どうぶんや	同分野
どうぶるい	胴震い
どうぶつゆ	動物油
どうふごう	同符号
どうふけん	道府県
どうびょう	同病
どうひょう	同表	道標
どうひせい	同飛成
どうばんが	銅版画
どうはかん	導波管
どうねんど	動粘度
どうにょう	導尿
どうにゅう	導入
どうでんい	同電位
どうていど	同程度
どうちるい	同値類
どうちょう	道庁	同調
どうちゅう	道中
どうちゃく	同着	撞着
どうちてき	同値的
どうちせい	同値性
どうちいき	同地域
どうだいら	堂平
どうそたい	同素体
どうそじん	道祖神
どうせだい	同世代
どうせいふ	同政府
どうじんし	同人誌
どうじょう	同乗	堂上	道場	同情	道上	同上
どうじゅん	同順
どうじだい	同時代
どうじせい	同時性
どうじこく	同時刻
どうじけん	同事件
どうじかん	同時間
どうしょく	同職	同色
どうしょう	道床	銅賞	同床
どうしゅつ	導出
どうしゅし	同趣旨
どうしゅく	同宿
どうしゅう	同臭	同舟
どうししゃ	同志社
どうしけい	動詞形
どうしかく	動詞格
どうしかい	同士会
どうしうち	同士撃ち	同士打ち
どうざっし	同雑誌
どうさよう	動作用
どうさてん	動作点
どうさそう	動作相
どうさせい	動作性
どうさしゅ	動作主
どうさぎれ	動作切
どうさおん	動作音
どうごげん	同語源
どうけいき	同形機
どうぐばこ	道具箱
どうぐだて	道具立て
どうくかん	同区間
どうぎょく	同玉
どうぎょう	同行	童形	同業
どうぎてき	道義的
どうぎしん	道義心
どうぎかい	道議会
どうきょり	同距離
どうきょく	同曲	同局
どうきょう	同郷	道鏡	同香	道教
どうきゅう	慟泣	撞球	同級
どうきてん	同期点
どうきてき	同期的
どうきづけ	動機付け
どうきせい	同期生	同期性
どうきしゅ	同機種
どうきしき	同期式
どうきがた	同期型
どうきかく	同規格
どうきかい	同期会
どうがたき	同型機
どうがぞう	動画像
どうがしま	堂ヶ島
どうかひか	同花被花
どうかせん	導火線
どうかこん	同化根
どうかかく	同価格
どうかいぎ	同会議
どうおんご	同音語
どういつわ	同一話
どういつし	同一視
どういつか	同一化
どういたい	同位体
どういそう	同位相
どういしょ	同意書
どういけん	同意見
どういかく	同位角
どあつけい	土圧計
でんわよう	電話用
でんわもう	電話網
でんわばん	電話番
でんわだい	電話台	電話代
でんわせん	電話線
でんわしつ	電話室
でんわぐち	電話口
でんれいし	伝令使
でんりょく	電力
でんりゅう	電流
でんりゃく	電略
でんりばこ	電離箱
でんりそう	電離層
でんりせい	電離性
でんりけん	電離圏
でんまーく	丁抹
でんぴょう	伝票
でんぱんろ	伝搬路
でんぱんは	伝搬波
でんぱほう	電波法
でんぱとう	電波塔
でんぱぜい	電波税
でんぱけん	電波研
でんぱけい	電波系
でんのうぶ	電脳部
でんのうか	電脳化
でんねつき	電熱器
でんどうば	殿堂馬
でんどうし	伝道師
でんどうき	電動機
でんちゅう	殿中	電柱
でんちだい	電池代
でんちしき	電池式
でんちぎれ	電池切れ
でんたつろ	伝達路
でんそうろ	伝送路
でんそうぶ	電送部
でんじょう	電情
でんじてき	電磁的
でんじしき	電磁式
でんじかい	電磁界
でんしんき	電信機
でんしょく	電飾
でんしょう	伝誦	伝唱	伝承
でんしゅう	伝習
でんしゃく	電車区
でんしゃか	電車化
でんしもじ	電子文字
でんしばん	電子版
でんしてき	電子的
でんしつい	電子対
でんしだい	電視台
でんしせん	電子線
でんししき	電子式
でんしこう	電子工
でんしけん	電子研
でんしけい	電子系
でんしきき	電子機器
でんしがく	電子学
でんしおん	電子音
でんさんぶ	電算部
でんさんき	電算機
でんさんか	電算課	電算化
でんげんぶ	電源部
でんげんぬ	電源抜
でんげんぎ	電源切
でんげんい	電源入
でんぎょう	伝教	電業
でんきょく	電極
でんきゅう	電球
でんきもの	電気物	伝奇物
でんきばん	電気版
でんきなべ	電気鍋
でんきとう	電気棟
でんきてん	電器店
でんきてき	電気的	伝記的
でんきだい	電気代	電機大
でんきせき	電気石
でんきせい	電器製	電機製
でんきしゃ	電気車
でんきしき	電気式
でんきけい	電気系
でんききき	電気機器
でんきがま	電気釜	電器釜
でんきがい	電器街	電気街
でんきいす	電気椅子
でんかまえ	電化前
でんえもん	伝衛門
でわのうみ	出羽海
でわにしき	出羽錦
でわざくら	出羽桜
でほうだい	出放題
でぶしょう	出不精
でづっぱり	出突っ張り
でだまりつ	出玉率
でだますう	出玉数
でぞめしき	出初式	出初め式
でずっぱり	出突っ張り
でずいらず	出ず入らず
でじたるか	デジタル化
でしぐらむ	瓰
でくのぼう	木偶の坊
できふでき	出来不出来
できじたい	出来自体
できしだい	出来次第
できごころ	出来心
できぐあい	出来具合
できあがり	出来上がり
でかぐらむ	瓧
でいりゅう	泥流
でいりぐち	出入り口	出入口
でいちゅう	泥中
でいたんち	泥炭地
であいけい	出会い系
でーたがた	データ型
だんわしつ	談話室
だんわかい	談話会
だんりょく	弾力
だんりゅう	暖流
だんらくめ	段落目
だんやくこ	弾薬庫
だんめんず	断面図
だんまつま	断末摩	断末魔
だんぼうひ	暖房費
だんぼうき	暖房器	暖房機
だんぼーる	段ボール
だんぺんか	断片化
だんばしご	段梯子
だんのうら	壇ノ浦
だんなさま	旦那様
だんちょう	断腸	団長
だんちゃく	彈着	弾着
だんちがい	段違い
だんせいむ	男性向
だんせいび	男性美
だんせいは	弾性波
だんせいし	男性誌
だんせいき	男性器
だんせいか	男性化
だんじょひ	男女比
だんじょさ	男女差
だんじょう	弾正	壇上
だんしよう	男子用
だんしょく	男色	暖色
だんしょう	断章	談笑	男妾	男娼
だんしゅん	暖春
だんしゅう	団集	男囚
だんしゃく	男爵
だんしめい	男子名
だんしべん	男子便
だんしはつ	男子初
だんしこう	男子高	男子校
だんさいき	断裁機
だんごむし	団子虫
だんごばな	団子鼻	だんご鼻
だんこんき	男根期
だんきろく	団鬼六
だんきゅう	段級	段丘	檀弓
だれひとり	誰一人
だれかさん	誰かさん
だめづまり	駄目詰まり	駄目詰り
だましうち	騙し討ち
だとうせい	妥当性
だてんおう	打点王
だてすがた	伊達姿
だてきみこ	伊達公子
だておとこ	伊達男
だつりょく	脱力
だつりゅう	脱硫
だつりゃく	奪略	奪掠
だつぶんか	脱分化
だついじょ	脱衣所
だついしつ	脱衣室
だっちょう	脱腸	脱調
だっちゃく	脱着
だったいご	脱退後
だっすいき	脱水機
だっしょく	脱色
だっしゅつ	脱出
だっしゅう	脱臭
だっしめん	脱脂綿
だっこくき	脱穀機
だっきゅう	脱臼
だっきゃく	脱却
だたいざい	堕胎罪
だそくへん	蛇足編
だせきすう	打席数
だせいしん	惰性心
だしゃすう	打者数
だしっぱな	出しっ放
だしおしみ	出し惜しみ
ださんてき	打算的
だげきわざ	打撃技
だげきめん	打撃面
だげきせん	打撃戦
だげきじん	打撃陣
だげきけい	打撃系
だけんすう	打鍵数
だくりゅう	濁流
だきまくら	抱き枕
だきにてん	荼枳尼天	荼吉尼天
だきあわせ	抱き合わせ
だかんけん	兌換券
だかいさく	打開策
だえんめん	楕円面
だえんたい	楕円体
だえんけい	楕円型	楕円形
だえんがた	楕円型
だえきせん	唾液腺
だいろんぎ	大論議
だいろまん	大浪漫
だいろっき	第六期
だいろうさ	大労作
だいれんさ	大連鎖
だいりょう	大領	代料
だいりびな	内裏雛
だいりはは	代理母
だいりにん	代理人
だいりてん	代理店
だいりせき	大理石
だいりけん	代理権
だいりーぐ	大リーグ
だいらんぶ	大乱舞
だいよんき	第四紀
だいよっか	第四日
だいよそく	大予測
だいよそう	大予想
だいよげん	大予言
だいもんじ	大文字
だいめいろ	大迷路
だいめいし	代名詞
だいみょう	大名
だいみてい	題未定
だいまじん	大魔神	大魔人
だいまおう	大魔王
だいぼさつ	大菩薩
だいほうし	大法師
だいほーる	大ホール
だいべんき	大便器
だいぶもん	大部門
だいぶまえ	大分前
だいぶぶん	大部分
だいぶちが	大分違
だいぶたい	大部隊	大舞台
だいぶきん	台布巾
だいぶーむ	大ブーム
だいふつか	第二日
だいふごう	大富豪
だいふくじ	大福寺
だいふぁん	大ファン
だいひょう	大兵	代表
だいひつや	代筆屋
だいひっと	大ヒット
だいばかり	台秤
だいはらん	大波乱
だいはどう	大波動
だいのはら	台原
だいにんき	大人気
だいにゅう	代入
だいにほん	大日本
だいにはん	第二版
だいにてん	第二点
だいにだん	第二弾
だいにせつ	第二節
だいにしん	第二審
だいにしゅ	第2種	第二種
だいにさく	第二作
だいにごう	第二号
だいにこう	第二項
だいにかん	第二巻	第二款
だいにかい	第2階	第2回	第二回
だいなんわ	第何話
だいなごん	大納言
だいどころ	台所
だいどうじ	大道寺
だいとしゃ	大都社
だいとくじ	大徳寺
だいとくい	大得意
だいとかい	大都会
だいとうし	大東市
だいとうあ	大東亜	大東亞
だいてんし	大転子	大天使
だいていり	大定理
だいちょう	大腸	台帳
だいちゅう	大中
だいちまお	大地真央
だいちえん	大遅延
だいだじん	代打陣
だいだげき	大打撃
だいだいり	大内裏
だいだいず	橙酢
だいたろう	大太郎
だいたばし	代田橋
だいたすう	大多数
だいたいぶ	大腿部
だいたいき	代替機
だいそしき	大組織
だいせいか	大成果
だいずかん	大図鑑
だいすたー	大スター
だいすうち	代数値
だいじろう	大二郎
だいじりん	大辞林
だいじょう	台上	大判官	大嘗	大乗	台状	大丈
だいじほう	大字報
だいじてん	大辞典	大事典
だいじせん	大辞泉
だいじしん	大地震
だいじげん	大字源
だいじけん	大事件
だいしょや	代書屋
だいしょう	大将	大小	大証	代償
だいしのう	大司農
だいしどう	大師堂
だいしだい	大市大
だいしぜん	大自然
だいしあい	大試合
だいさんわ	第三話
だいさんぶ	第三部
だいさんじ	大惨事
だいさんき	第三期	第三紀
だいごせん	第五戦
だいごせつ	第五節
だいごしん	大誤審
だいごさん	大誤算
だいごかん	第五巻
だいごかい	第５回	大語界	大誤解
だいこんは	大根葉
だいこうや	代行屋
だいこうじ	大工事
だいこうざ	大講座
だいけんい	大権威
だいぐさく	大愚作
だいぐうじ	大宮司
だいくまち	大工町
だいくせん	大苦戦
だいぎもん	大疑問
だいぎせい	代議制
だいぎいん	代議員
だいきらい	大嫌い
だいきょう	大京	大凶
だいきゅう	代休
だいきぼか	大規模化
だいがわり	代替り
だいがらん	大伽藍
だいがめん	大画面
だいがくぶ	大学部
だいがくで	大学出
だいがくじ	大学時
だいがえち	代替地
だいかんわ	大漢和
だいかぶつ	代価物
だいかひん	代価品
だいかぞく	大家族
だいかくじ	大覚寺
だいかあん	代価案
だいいどう	大移動
だいいっぽ	第一歩
だいいっぱ	第一波
だいいっし	第一子
だいいっき	第一期
だいいっか	第一課
だいいちわ	第一話
だいいちぶ	第一部
だいいちじ	第一次
だいいちざ	大一座
だいいちぎ	第一義
だいいちい	第一位
だいいせき	大遺跡
だいあんじ	大安寺
だいあくま	大悪魔
どんぶりもの	丼物
どんぶりめし	丼飯
どんぶりばち	丼鉢
どろぼうねこ	泥棒猫
どれすすがた	ドレス姿
どれいせいど	奴隷制度
どりんくざい	ドリンク剤
どりょくぎむ	努力義務
どりょうこう	度量衡
どようしんや	土曜深夜
どめいんめい	ドメイン名
どみのりろん	ドミノ理論
どみのたおし	ドミノ倒し
どまんじゅう	土饅頭
どぼくこうじ	土木工事
どぼくぎょう	土木業
どひょうぎわ	土俵際
どひょういり	土俵入り	土俵入
どにちちゅう	土日中
どにちいがい	土日以外
どっとたんい	ドット単位
どっこうせん	独航船
どっきんほう	独禁法
どせきりゅう	土石流
どすうぶんぷ	度数分布
どじょうめん	土壌面
どじょうなべ	泥鰌鍋
どじょうない	土壌内
どじょうがた	土壌型
どしょうまち	道修町
どしょうぼね	土性骨
どしゃくずれ	土砂崩れ
どこんじょう	ど根性
どけんぎょう	土建業
どくりょうご	読了後
どくりつとう	独立党
どくりつてん	独立点
どくりつせい	独立性
どくりつじゅ	独立樹
どくりつこく	独立国
どくりつけい	独立系
どくりつがた	独立型
どくりつあん	独立案
どくにんじん	毒人参
どくだんろん	独断論
どくだんてき	独断的
どくそうよう	独奏用
どくそうてき	独創的
どくそうせい	独創性
どくそうしゃ	独奏者	独創者
どくそうかい	独奏会
どくぜんてき	独善的
どくぜんせい	独善性
どくぜんしゃ	独善者
どくぜつせん	毒舌戦
どくせんよく	独占欲
どくせんてき	独占的
どくせいぶん	毒成分
どくじろせん	独自路線
どくじしよう	独自仕様
どくじきかく	独自規格
どくじかいろ	独自回路
どくしんもの	独身者
どくしんしゃ	独身者
どくしょれき	読書歴
どくしょとう	読書灯
どくしょじん	読書人
どくしょかい	読書会
どくしゃらん	読者欄
どくしゃそう	読者層
どくしゃすう	読者数
どくしゃがわ	読者側
どくさいせい	独裁制
どくさいしゃ	独裁者
どくきんほう	独禁法
どきぶんめい	土器文明
どうわぶらく	同和部落
どうわしゅう	童話集
どうわさべつ	同和差別
どうわさっか	童話作家
どうろゆそう	道路輸送
どうろちょう	道路長
どうろせいび	道路整備
どうろじょう	道路上
どうろこうじ	道路工事
どうるいこう	同類項
どうりんけい	動輪径
どうりょくろ	動力炉
どうりょくぶ	動力部
どうりきがく	動力学
どうらくもの	道楽者
どうゆうかい	同友会
どうめいしゃ	同盟者
どうめいこく	同盟国
どうめいぐん	同盟軍
どうめいいし	同名異市
どうみんぜい	道民税
どうみょうじ	道明寺
どうほうこく	同報告
どうほうこう	同方向
どうほうあん	同法案
どうぶんしょ	同文書
どうぶつめい	動物名
どうぶつたち	動物達
どうぶつせい	動物性
どうぶつしつ	動物質
どうぶつぐん	動物群
どうぶつがく	動物学
どうぶつかい	動物界
どうぶつえん	動物園
どうびょうし	銅拍子
どうばんぐみ	同番組
どうはんしゃ	同伴者
どうねんれい	同年齢
どうねんだい	同年代
どうにゅうぶ	導入部
どうにゅうじ	導入時
どうにゅうき	導入期
どうないよう	同内容
どうとんぼり	道頓堀
どうとくてん	同得点
どうとくてき	道徳的
どうとくせい	道徳性	動特性
どうとくしん	道徳心
どうとくかん	道徳観	道徳感
どうとうひん	同等品	同当品
どうとうせい	同等性
どうでんりつ	導電率
どうでんたい	導電体
どうでんせい	導電性
どうてんだん	同点弾
どうていりつ	同定率
どうていあん	同提案
どうちゅうき	道中記
どうちじせん	道知事選
どうだいがく	同大学
どうたいけい	胴体径	同体型
どうそうせい	同窓生
どうそうかい	同窓会
どうせんこう	同専攻
どうせいのう	同性能
どうせいあい	同性愛
どうじんしゃ	同人社
どうじょうじ	道成寺
どうじゅんい	同順位
どうじそうさ	同時操作
どうしんえん	同心円
どうしりょう	同資料
どうしゅつぎ	導出木
どうしゅぞく	同種族
どうしゅうき	同周期
どうしゃせい	同社製
どうしつせい	同質性
どうさふのう	動作不能
どうさていし	動作停止
どうさちゅう	動作中
どうさそくど	動作速度
どうさげんり	動作原理
どうさくしゃ	同作者
どうさきしゅ	動作機種
どうさかのう	動作可能
どうごうきん	銅合金
どうこくじん	同国人
どうこうほう	道交法
どうこうのし	同好の士
どうこうなど	動向等
どうこうしゃ	同行者
どうこうこう	同高校
どうこうかい	同好会
どうげんざか	道玄坂
どうけいれつ	同系列
どうけいとう	同系統
どうけいたい	同形態
どうけいせい	同型性	同形性
どうぐだたみ	道具畳
どうくつない	洞窟内
どうぎじょう	道義上
どうきょにん	同居人
どうきょしゃ	同居者
どうきょうい	道教委
どうきじょう	動機上
どうきしょり	同期処理
どうききこう	同期機構
どうきかさん	同期加算
どうきかいろ	同期回路
どうがたしゃ	同型車
どうがたかん	同型艦
どうがくねん	同学年
どうかんとく	同監督
どうかんすう	導関数
どうかそしき	同化組織
どういんりつ	動員率
どういんすう	動員数
どういつわく	同一枠
どういつりつ	同一律
どういつもじ	同一文字
どういつめい	同一名
どういつびん	同一便
どういつはん	同一犯
どういつねん	同一年
どういつにん	同一人
どういつてん	同一点
どういつぞく	同一属
どういつせん	同一線
どういつせい	同一性
どういつえき	同一駅
どういっしゅ	同一種
どういたいひ	同位体比
どういげんそ	同位元素
でんわりょう	電話料
でんわよやく	電話予約
でんわちょう	電話帳
でんわちゅう	電話中
でんわけんり	電話権利
でんわぎょう	電話業
でんわきょく	電話局
でんわきゅう	電話級
でんわきのう	電話機能
でんりゅうち	電流値
でんまちょう	伝馬町
でんまーくご	デンマーク語
でんぽうぶん	電報文
でんぷんしつ	澱粉質
でんぷやじん	田夫野人
でんぶんてき	伝聞的
でんぶんしゃ	伝聞者
でんぱんこう	伝搬項
でんぱんけい	伝搬系
でんぱりよう	電波利用
でんぱほうき	電波法規
でんぱぶつり	電波物理
でんぱどけい	電波時計
でんのうとし	電脳都市
でんのうがい	電脳街
でんねつせん	電熱線
でんどうりつ	伝導率
でんどうたい	伝導体
でんどうせい	電導性	伝導性
でんどうしゃ	電動車
でんどうしき	電動式
でんどうけい	伝導系
でんどういり	殿堂入り
でんとうてき	伝統的
でんとうせん	電灯線
でんとうこう	伝統校
でんつうだい	電通大	電気通信大学
でんつうけん	電通研
でんちぶぶん	電池部分
でんちふよう	電池不要
でんちくどう	電池駆動
でんたつりつ	伝達率
でんたつしゃ	伝達者
でんたつけん	伝達権
でんたつけい	伝達系
でんたくがた	電卓型
でんたいばん	電胎版
でんそうひん	電装品
でんそうだい	電総大
でんそうしき	電送式
でんそうけん	電総研	電子技術総合研究所	伝送研
でんそうけい	電装系	伝送系
でんせんひき	電線引
でんせんせい	伝染性
でんせつぶつ	伝説物
でんせつてき	伝説的
でんせいかん	伝声管
でんじりょく	電磁力
でんじしゃく	電磁石
でんじきがく	電磁気学
でんしわおん	電子和音
でんしれんじ	電子レンジ
でんしれいき	電子励起
でんしょばと	伝書鳩
でんしゆそう	電子輸送
でんしゃよう	電車用
でんしゃみち	電車道
でんしゃない	電車内
でんしゃちん	電車賃
でんしゃだい	電車代
でんしゃせん	電車線
でんしゃかん	田舎漢
でんしゃえき	電車駅
でんしめいる	電子メイル
でんしめーる	電子メール
でんしまねー	電子マネー
でんしぶんぷ	電子分布
でんしぶひん	電子部品
でんしぶつり	電子物理
でんしぶっく	電子ブック
でんしぴあの	電子ピアノ
でんしはいち	電子配置
でんしせんい	電子遷移
でんしせいふ	電子政府
でんしせいき	電子精機
でんしじゅう	電子銃
でんしじてん	電子辞典
でんしじしょ	電子辞書
でんしきょう	電子協	電子工業振興協会
でんしきどう	電子軌道
でんしきそぶ	電子基礎部
でんしききぶ	電子機器部
でんしきかい	電子機械
でんしがっき	電子楽器
でんしかいろ	電子回路
でんしかいぎ	電子会議
でんさんしつ	電算室
でんごんばん	伝言板
でんこうばん	電光板
でんこうしき	電光式
でんげんよう	電源用
でんげんばん	電源板
でんげんつき	電源付
でんげんせん	電源線
でんげんしゃ	電源車
でんげんがわ	電源側
でんげんいり	電源入
でんげきてき	電撃的
でんげきおう	電撃王
でんきりろん	電気理論
でんきりょう	電気量
でんきもうふ	電気毛布
でんきほせい	電気補正
でんきぶらん	電気ブラン
でんきひつじ	電気羊
でんきどりる	電気ドリル
でんきでんし	電気電子
でんきそうち	電気装置
でんきせつび	電気設備
でんきじかけ	電気仕掛
でんきしげき	電気刺激
でんきこうじ	電気工事
でんきけいじ	電気計時
でんきくどう	電気駆動
でんききかい	電気機械
でんきがっき	電気楽器
でんきがっか	電気学科
でんきかがく	電気化学
でんきかいろ	電気回路
でんきかいり	電気解離
でんきえいが	伝記映画
でんきうなぎ	電気鰻
でんかりょう	電荷量
でんかみつど	電荷密度
でんかぶんぷ	電荷分布
でんかくかん	電化区間
でんかいない	電界内
でんかいしつ	電解質
でんおんけい	伝音系
でんえんとし	田園都市
でんあつげん	電圧源
でんあつけい	電圧計
でまちやなぎ	出町柳
でふぉるとち	デフォルト値
でびゅーせん	デビュー戦
でびゅーさく	デビュー作
でしりっとる	竕
でさききかん	出先機関
でこぼこみち	凸凹道
でげねりあか	Degeneriaceae	デゲネリア科
でぐちふきん	出口付近
でかりっとる	竍
でかめーとる	籵
でかたしだい	出方次第
でいばんがん	泥板岩
であしばらい	出足払い
であいがしら	出合い頭
だんわりかい	談話理解
だんろんぽう	段論法
だんれいぼう	暖冷房
だんらくわく	段落枠
だんらくめい	段落名
だんらくかん	段落間
だんめんせき	断面積
だんぼうよう	暖房用
だんぺんてき	断片的
だんぺんぐん	断片群
だんぱつしき	断髪式
だんねつふく	断熱服
だんねつせい	断熱性
だんねつざい	断熱材
だんどうだん	弾道弾
だんどうがく	弾道学
だんとうだい	断頭台
だんていてき	断定的
だんたいわく	団体枠
だんたいよう	団体用
だんたいめい	団体名
だんたいない	団体内
だんたいせん	団体戦
だんたいかん	団体間
だんぞくてき	断続的
だんそうめん	断層面
だんそうほう	断層法
だんせいろん	弾性論
だんせいよう	男性用
だんせいめい	男性名
だんせいむけ	男性向
だんせいばん	弾性板
だんせいてき	男性的
だんせいたい	弾性体
だんせいぞう	男性像
だんせいじん	男性陣
だんせいけい	弾性系
だんせいがわ	男性側
だんせいがた	男性形
だんせいがく	弾性学	男性学
だんじょべつ	男女別
だんじょとも	男女共
だんじょかん	男女間
だんじくしき	段軸式
だんしりょう	男子寮
だんしといれ	男子トイレ
だんしせいと	男子生徒
だんしきょう	弾指頃
だんごじょう	団子状
だんごうざか	談合坂
だんここうぎ	断固抗議
だんこきょひ	断固拒否
だんけつけん	団結権
だんきゅうい	段級位
だんかいてき	段階的
だんおんたい	暖温帯
だるまおとし	達磨落し	達磨落とし
だましだまし	騙し騙し
だぼくしょう	打撲傷
だとうしごく	妥当至極
だてもんべつ	伊達紋別
だてまさむね	伊達政宗
だつりゅうか	脱硫化
だつらくしゃ	脱落者	脱落車
だつしゅりつ	奪取率
だつさんしん	奪三振
だつこうちく	脱構築
だついじょう	脱衣場
だっぴちゅう	脱皮中
だっちゃくか	脱着可
だっせんじこ	脱線事故
だっすいそう	脱水槽
だっしゅつじ	脱出時
だっしゅうき	脱臭器
だっしにゅう	脱脂乳
だっかいせん	奪回戦
だせいせっき	打製石器
だじょうかん	太政官
だざいおさむ	太宰治
だげきりょく	打撃力
だげきぶもん	打撃部門
だげきふしん	打撃不振
だげきけっか	打撃結果
だけんそくど	打鍵速度
だきょうてん	妥協点
だきょうがた	妥協型
だきょうあん	妥協案
だきゅうかん	打球感
だきみょうが	抱茗荷
だかんしへい	兌換紙幣
だえんじょう	楕円状
だえんきどう	楕円軌道
だうんしょう	ダウン症
だいわだんち	大和団地
だいわくせい	大惑星
だいろんそう	大論争
だいろっかん	第六感
だいろっかい	第六回	第６回
だいろくせつ	第六節
だいれんごう	大連合
だいれんあい	大恋愛
だいりょこう	大旅行
だいりしょう	代理商
だいりこうい	代理行為
だいりくれい	大陸令
だいりーがー	大リーガー
だいらんせん	大乱戦
だいらんこう	大乱交
だいよんぺん	第四辺
だいよんばん	第四版
だいよんせつ	第四節
だいよんこう	第四項
だいよんかん	第四款
だいよんかい	第四回
だいようひん	代用品
だいようさい	大要塞
だいようかい	大妖怪
だいゆうかい	大誘拐
だいやくまん	大役満
だいやくしん	大躍進
だいもんだい	大問題
だいめんせき	大面積
だいめいわす	題名忘
だいめいわく	大迷惑
だいめいぶつ	大名物
だいめいどお	題名通
だいまんぞく	大満足
だいまるまえ	大丸前
だいまきょう	大魔境
だいぼしゅう	大募集
だいぼうらく	大暴落
だいぼうどう	大暴動
だいぼうとう	大暴投	大暴騰
だいぼうそう	大暴走
だいぼうけん	大冒険
だいほんめい	大本命
だいほんざん	大本山
だいほんえい	大本営
だいほうてい	大法廷
だいべんにん	代弁人
だいべんしゃ	代弁者
だいへんらく	大変楽
だいへんどう	大変動
だいへんたい	大編隊
だいへんせい	大編成
だいへんこう	大変更
だいへんかく	大変革
だいへいれつ	大並列
だいへいげん	大平原
だいぶんるい	大分類
だいぶんせつ	大文節
だいぶむかし	大分昔
だいぶいぜん	大分以前
だいふっかつ	大復活
だいふくもち	大福餅
だいひんみん	大貧民
だいひょうば	代表馬
だいひょうち	代表値
だいひゃっか	大百科
だいひきゅう	大飛球
だいばってき	大抜擢
だいばくはつ	大爆発
だいはんてん	大飯店
だいはんたい	大反対
だいはつめい	大発明
だいはっせい	大発生
だいはっけん	大発見
だいはっかい	大発会
だいはくしゅ	大拍手
だいのおとこ	大の男
だいのうかい	大納会
だいねっせん	大熱戦
だいにんずう	大人数
だいにようそ	第2要素
だいにゅーす	大ニュース
だいにっぽん	大日本
だいにちだけ	大日岳
だいにちぎん	第二地銀
だいにせだい	第二世代
だいにしょう	第二章	第2章
だいにしゅう	第二週	第2週
だいにしあい	第二試合
だいにこうざ	第二講座
だいにきょく	第二局
だいにきぼう	第二希望
だいにかいめ	第二回目
だいなんかい	第何回
だいななせつ	第七節
だいななかい	第７回
だいどうげい	大道芸
だいとしけん	大都市圏
だいとしかん	大都市間
だいとうろん	大討論
だいとうだい	大東大
だいとうぞく	大盗賊
だいとうじん	大東陣
だいてんもく	台天目
だいてんとう	大転倒
だいてんさい	大天才
だいてんかん	大転換
だいてつじん	大鉄人
だいていでん	大停電
だいていたく	大邸宅
だいていこく	大帝国
だいついせき	大追跡
だいちぼしん	大地母神
だいだんそう	大断層
だいだんえん	大団円	大団圓
だいだっそう	大脱走
だいだいてき	大々的
だいだいいろ	橙色	だいだい色
だいたいほう	代替法
だいたいぶつ	代替物
だいたいひん	代替品
だいたいざい	代替財
だいたいこつ	大腿骨
だいたいけい	大腿頚
だいたいおな	大体同
だいたいあん	代替案
だいぞうげん	大増減
だいぞうかん	大増刊
だいぞういん	大増員
だいそんがい	大損害
だいそうげん	大草原
だいぜんてい	大前提
だいせんぷう	大旋風
だいせんぱい	大先輩
だいせんでん	大宣伝
だいせんだん	大船団
だいせんそう	大戦争
だいせんせい	大先生
だいせんしゅ	大選手
だいせんかん	大戦艦
だいせつざん	大雪山
だいせっけい	大雪渓
だいせっきん	大接近
だいせきはん	大赤斑
だいせいどう	大聖堂
だいせいこう	大成功
だいせいかい	大正解
だいせいえん	大声援
だいせいうん	大星雲
だいすうてき	代数的
だいすうたい	代数体
だいすうしき	代数式
だいすうけい	代数系
だいすうきか	代数幾何
だいすうがく	代数学
だいすうかい	代数解
だいすいせい	大彗星
だいすいがい	大水害
だいすーしー	大四喜
だいじんぶつ	大人物
だいじんどう	大仁堂
だいじんぐう	大神宮
だいじょゆう	大女優
だいじょうぶ	大丈夫
だいじょうじ	大乗寺
だいじだいひ	大慈大悲
だいしんゆう	大親友
だいしんぶん	大新聞
だいしんぱん	大信販
だいしんでん	大神殿
だいしんさい	大震災
だいしんいん	大審院
だいしょにん	代書人
だいしょてん	大書店
だいしょっく	大ショック
だいしょうり	大捷利	大勝利
だいしょうじ	大聖寺
だいしゅっせ	大出世
だいしゅぞく	大種族
だいしゃわく	台車枠
だいしゃりん	大車輪
だいしゃめん	大斜面
だいしゃない	台車内
だいしゃかん	台車間
だいしっぱい	大失敗
だいしったい	大失態
だいしっこう	代執行
だいしきょう	大司教
だいしきゅう	大至急
だいしがわら	大師河原
だいざんぱい	大惨敗
だいざんさつ	大惨殺
だいざえもん	大左衛門
だいざいてき	題材的
だいさんばん	第三版
だいさんにち	第三日
だいさんだん	第三弾	第３段	第３弾
だいさんせん	第三戦
だいさんせつ	第三節
だいさんせい	大賛成
だいさんしゅ	第三種
だいさんしゃ	第三者
だいさんざい	大散財
だいさんごく	第三国
だいさんこう	第三項
だいさんげん	大三元
だいさんかん	第三款	第三巻
だいさんかい	第３回
だいさぶろう	大三郎
だいさつりく	大殺戮
だいさくせん	大作戦
だいさぎょう	大作業
だいさいなん	大災難
だいさいがい	大災害
だいさーびす	大サービス
だいごんげん	大権現
だいごせだい	第五世代	第５世代
だいごしあい	第五試合
だいごくでん	大極殿
だいこんらん	大混乱
だいこんせん	大混戦	大混線
だいこんざつ	大混雑
だいこんあし	大根足
だいこくどう	大黒堂
だいこくてん	大黒天
だいこうもく	大項目
だいこうぶつ	大好物
だいこうふん	大興奮
だいこうどう	大講堂
だいこうてん	代行店
だいこうせい	大攻勢
だいこうずい	大洪水
だいこうしん	大行進
だいこうしゃ	代行者
だいこうこく	大広告
だいこうけん	代行権
だいこうけい	大口径
だいこうかい	大後悔	大公開	大航海
だいげんにん	代言人
だいげんそく	大原則
だいげんかい	大言海
だいげきせん	大激戦
だいけんとう	大健闘
だいけっさく	大傑作
だいけいそく	台形則
だいけいかく	大計画
だいくうこう	大空港
だいぎんこう	大銀行
だいぎょうじ	大行事
だいぎせいど	代議制度
だいぎしすう	代議士数
だいきんぼし	大金星
だいきゅうし	大休止	大臼歯
だいきぼてん	大規模店
だいきぎょう	大企業
だいがんめん	大顔面
だいがっこう	大学校
だいがくめい	大学名
だいがくまえ	大学前
だいがくない	大学内
だいがくそつ	大学卒
だいがくぜい	大学勢
だいがくせん	大学戦
だいがくせい	大学生
だいがくじん	大学人
だいがくさい	大学祭
だいがくがわ	大学側
だいがくがえ	大学帰
だいがくかん	大学間
だいがくいん	大学院
だいがくいも	大学芋
だいがえしゃ	代替車
だいがいしゃ	大会社
だいかんやま	代官山
だいかんどう	大感動
だいかんそう	大観荘
だいかんせん	大幹線
だいかんせい	大喚声	大歓声
だいかんしゃ	大感謝
だいかんさま	代官様
だいかんげき	大感激
だいかんげい	大歓迎
だいかつやく	大活躍
だいかっせん	大合戦
だいかくめい	大革命
だいかえあん	代替案
だいかいれい	大海令
だいかいてん	大回転
だいかいてい	大改訂
だいかいぞく	大海賊
だいかいぞう	大改造
だいかいせん	大海戦
だいかいせい	大改正
だいおんせい	大音声
だいえんぜつ	大演説
だいえんかい	大宴会
だいえいだん	大英断
だいうちゅう	大宇宙
だいいんしん	大陰唇
だいいっぽう	第一報
だいいっぱん	第1版	第一版
だいいってん	第一点
だいいっせん	第一戦	第一線
だいいっせつ	第一節
だいいっせい	第一声
だいいっしん	第一審
だいいっしゅ	第一種	第1種
だいいっさく	第一作
だいいっこう	第一稿	第一項
だいいっかん	第一勘	第一感	第一巻	第一款
だいいっかい	第一階	第1回	第１回	第一回
だいいちろう	大一郎
だいいちもん	第一問
だいいちびん	第一便
だいいちにち	第一日	第１日
だいいちちく	第一地区
だいいちだん	第一段	第一弾	第１弾
だいいちじん	第一陣
だいいちごう	第１号	第一号
だいいちこう	第一項
だいいきてき	大域的
どんでんがえし	どんでん返し
どろぬまりゅう	泥沼流
どれいぼうえき	奴隷貿易
どれいどうとく	奴隷道徳
どれいかいほう	奴隷解放
どるいどきょう	ドルイド教
どるいきんぞく	土類金属
どりょくちゅう	努力中
どりょくしょう	努力賞
どりょくかてい	努力過程
どようにちよう	土曜日曜
どびゃくしょう	土百姓
どっかいりょく	読解力
どじょうおせん	土壌汚染
どしゃさいがい	土砂災害
どさくさまぎれ	どさくさ紛れ
どごうれっしん	土豪劣紳
どくりつりろん	独立理論
どくりつどっぽ	独立独歩
どくりつこっか	独立国家
どくだんじょう	独壇場
どくそうりょく	独創力
どくそうきょく	独奏曲
どくぜんしゅぎ	独善主義
どくせんじょう	独擅場
どくせんしよう	独占使用
どくじほうしき	独自方式
どくじちょうさ	独自調査
どくじぎじゅつ	独自技術
どくじかいはつ	独自開発
どくしんりょう	独身寮
どくしんどうし	独身同士
どくしんじゅつ	読心術	読唇術
どくしんじだい	独身時代
どくしんきぞく	独身貴族
どくしんおとこ	独身男
どくしょりょく	読書力
どくしょうしゃ	独唱者
どくしゅうしょ	独習書
どくしゃじしん	読者自身
どくしゃしょし	読者諸子
どくしゃさんか	読者参加
どくさいせいじ	独裁政治
どくさいこっか	独裁国家
どくごかんそう	読後感想
どくがんりゅう	独眼竜
どくかいりょく	読解力
どきがわぶぶん	土器川部分
どうわもんだい	同和問題
どうわちくがい	同和地区外
どうろみぎがわ	道路右側
どうろふくいん	道路幅員
どうろひょうじ	道路標示	道路表示
どうろばんごう	道路番号
どうろはくしょ	道路白書
どうろとうけい	道路統計
どうろちずぼん	道路地図本
どうろじじょう	道路事情
どうろこんざつ	道路混雑
どうろこうつう	道路交通
どうろこうだん	道路公団
どうろけんせつ	道路建設
どうろけいかく	道路計画
どうろかんけい	道路関係
どうるいたすう	同類多数
どうりょくせん	動力船
どうりょくしゃ	動力車
どうりょくげん	動力源
どうりょくいん	動力因
どうりょうやく	同僚役
どうりょうきん	同料金
どうりつしゅい	同率首位
どうらくむすめ	道楽娘
どうめいひこう	同盟罷工
どうめいきょく	同名曲
どうめいえいが	同名映画
どうみょうじこ	道明寺粉
どうみゃくない	動脈内
どうみゃくけつ	動脈血
どうべんきこう	動弁機構
どうふけんぜい	道府県税
どうびょういん	同病院
どうばんがてん	銅版画展
どうにゅうまえ	導入前
どうにゅうほう	導入法
どうにゅうてき	導入的
どうにゅうざい	導入剤
どうにゅうぐち	導入口
どうどうめぐり	堂々巡り
どうとくじょう	道徳上
どうとくきはん	道徳規範
どうとうきのう	同等機能
どうてきろんり	動的論理
どうてききごう	動的記号
どうてきかてい	動的仮定
どうちょうてん	同調点
どうちょうしゃ	同調者
どうちかんけい	同値関係
どうたいほぞん	動体保存	動態保存
どうそうかいし	同窓会誌
どうせいちゅう	同棲中
どうせいじだい	同棲時代
どうじんしるい	同人誌類
どうじんしよう	同人誌用
どうじろくおん	同時録音
どうじょうやぶ	道場破
どうじょうない	道場内
どうじょうてき	同情的
どうじょうしん	同情心
どうじょうしゃ	同乗者
どうじょうけん	同条件
どうじゅんかい	同潤会
どうじぼしゅう	同時募集
どうじほっそく	同時発足
どうじほうそう	同時放送
どうじひょうじ	同時表示
どうじはつばい	同時発売
どうじはつおん	同時発音
どうじどうしょ	同時同所
どうじとうこう	同時投稿
どうじてんとう	同時点灯
どうじつうやく	同時通訳
どうじちょうり	同時調理
どうじだいせい	同時代性
どうじせんきょ	同時選挙
どうじじっこう	同時実行
どうじしんこう	同時進行
どうじこくめん	同時刻面
どうじこうしん	同時更新
どうじけいすう	同時計数
どうじくじょう	同軸上
どうじかいさい	同時開催
どうじえんそう	同時演奏
どうしょくぶつ	動植物
どうしょくけい	同色系
どうしょうてん	同焦点
どうしょういむ	同床異夢
どうしゅんてん	道春点
どうしゅつほう	導出法
どうしゅつさき	導出先
どうしゅつけい	導出系
どうしゅつがた	導出型
どうしゅうせい	道州制
どうししゃだい	同志社大
どうしさくひん	同氏作品
どうしかつよう	動詞活用
どうしかいどう	道志街道
どうさほしょう	動作保証
どうさふりょう	動作不良
どうさとくせい	動作特性
どうさでんあつ	動作電圧
どうさつりょく	洞察力
どうさじっせき	動作実績
どうさじっけん	動作実験
どうさかくにん	動作確認
どうごはんぷく	同語反復
どうごおんせん	道後温泉
どうけいしょく	同系色
どうけいさんき	同計算機
どうくつせんし	洞窟戦士
どうぎょうしゅ	同業種
どうぎょうしゃ	同業者
どうぎはんぷく	同義反復
どうぎごじしょ	同義語辞書
どうきょうじん	同郷人
どうきょうけい	道教系
どうきゅうせい	同級生
どうきゅうしゃ	同厩舎
どうきほうしき	同期方式
どうきてんそう	同期転送
どうきつうしん	同期通信
どうきせつぞく	同期接続
どうきしんごう	同期信号
どうがまいすう	動画枚数
どうかんようそ	導管要素
どうかごうぶつ	銅化合物
どうかこうぞう	同化構造
どうかいじょう	同会場
どうかいぎいん	道会議員
どうおんいぎご	同音異義語
どういんりょく	動員力
どういつろせん	同一路線
どういつふごう	同一符号
どういつそしき	同一組織
どういつせかい	同一世界
どういつじこく	同一時刻
どういつしゅし	同一主旨
どういつしほん	同一資本
どういつげんご	同一言語
どういつぎょう	同一行
どういつきしゅ	同一騎手	同一機種
どういいんかい	同委員会
どうあんたすう	同案多数	同案他数
でんわれんらく	電話連絡
でんわばんごう	電話番号
でんわちょうさ	電話調査
でんわたんまつ	電話端末
でんわそうだん	電話相談
でんわじじょう	電話事情
でんわがいしゃ	電話会社
でんわかんれん	電話関連
でんわかんゆう	電話勧誘
でんわかいせん	電話回線
でんわいっぽん	電話一本
でんわあんない	電話案内
でんりょくもう	電力網
でんりょくせん	電力線
でんりょくけい	電力計
でんりゅうせん	電留線
でんりゅうげん	電流源
でんりゅうけい	電流計
でんりそんしつ	電離損失
でんぽうきょく	電報局
でんぶんちょう	伝聞調
でんぱんそくど	伝搬速度
でんぱんじかん	伝搬時間
でんぱんけいろ	伝搬経路
でんぱんきこう	伝播機構
でんぱぼうがい	電波妨害
でんぱばいたい	電波媒体
でんぱでんぱん	電波伝搬
でんぱでんそう	電波電送	電波伝送
でんぱてんたい	電波天体
でんぱしんぶん	電波新聞
でんぱこうせん	電波高専
でんぱけいしき	電波形式
でんぱかんすう	伝播関数
でんのうづくえ	電脳机
でんのうせんし	電脳戦士
でんのうじしょ	電脳辞書
でんのうくらぶ	電脳倶楽部
でんのうがろう	電脳画廊
でんてつひめじ	電鉄姫路
でんちゅうばん	電鋳版
でんちゅうけん	電中研
でんちないぞう	電池内蔵
でんちせいぞう	電池製造
でんちこうかん	電池交換
でんたつそしき	伝達組織
でんたつげーと	伝達ゲート
でんたつけいろ	伝達経路
でんたくきのう	電卓機能
でんたくかたて	電卓片手
でんそうりょう	伝送量
でんそうちゅう	伝送中
でんそうそくど	伝送速度
でんそうしょり	電送処理
でんそうけいろ	伝送経路
でんせんびょう	伝染病
でんせんおんど	電線音頭
でんせつじょう	伝説上
でんせつしゅう	伝説集
でんじりきがく	電磁力学
でんじょうつう	電情通
でんじゆうどう	電磁誘導
でんじちょうり	電磁調理
でんじそうおん	電磁騒音
でんじきりろん	電磁気理論
でんしんばしら	電信柱
でんしんでんわ	電信電話
でんしんきゅう	電信級
でんしりょうし	電子量子
でんしょくこう	電色光
でんしょうしゃ	伝承者
でんしゆうびん	電子郵便
でんしゃりよう	電車利用
でんしゃいがい	電車以外
でんしぶっせい	電子物性
でんしばいたい	電子媒体
でんしとりひき	電子取引
でんしとうろん	電子討論
でんしてちょう	電子手帳
でんしつうしん	電子通信
でんしちゃっか	電子着火
でんしそうちぶ	電子装置部
でんしせってん	電子接点
でんしせいぎょ	電子制御
でんししょめい	電子署名
でんししょせき	電子書籍
でんしこうさく	電子工作
でんしこうがく	電子工学
でんしけっさい	電子決済
でんしけいさん	電子計算
でんしぎじゅつ	電子技術
でんしききるい	電子機器類
でんしかんけい	電子関係
でんしおんがく	電子音楽
でんさんしょり	電算処理
でんさんきしつ	電算機室
でんこうせっか	電光石火
でんこうけいじ	電光掲示
でんげんふよう	電源不要
でんげんたんし	電源端子
でんげんせつび	電源設備
でんげんこうじ	電源工事
でんげんかいろ	電源回路
でんげんいがい	電源以外
でんきろくおん	電気録音
でんきろうれん	電気労連
でんきりきせん	電気力線
でんきりきがく	電気力学
でんきょくひん	電極品
でんきょうしゃ	電響社
でんきほうしき	電気方式
でんきぶんかい	電気分解
でんきてつどう	電気鉄道
でんきていこう	電気抵抗
でんきつうしん	電気通信
でんきだいなど	電気代等
でんきだいがく	電機大学
でんきそうじき	電気掃除機
でんきせいひん	電気製品	電器製品
でんきせいぎょ	電気制御
でんきすたんど	電気スタンド
でんきじぎょう	電気事業
でんきじきがく	電気磁気学
でんきしんごう	電気信号
でんきこうじし	電気工事士
でんきこうがく	電気工学
でんきけいとう	電気系統
でんきがっかい	電気学会
でんきかんりし	電気管理士
でんきかんけい	電気関係
でんきえいどう	電気泳動
でんがくどうふ	田楽豆腐
でんかもくてき	電化目的
でんかほうしき	電化方式
でんかせいひん	電化製品
でんかけいかく	電化計画
でんかかんせい	電化完成
でんあつていか	電圧低下
でんあつこうか	電圧降下
でわのうみべや	出羽海部屋
でばぼうちょう	出刃包丁	出刃庖丁
でっちょうそう	粘葉装
でっちぼうこう	丁稚奉公
でぐちちょうさ	出口調査
でくにんぎょう	木偶人形
できだかばらい	出来高払い
でぃみぬえんど	diminuendo	dim
でぃーぜるしゃ	ディーゼル車
でーたてんそう	データ転送
でーたつうしん	データ通信
だんれいぼうひ	暖冷房費
だんりょくてき	弾力的
だんりょくせい	弾力性
だんぼうちゅう	暖房中
だんぼうかんり	暖房管理
だんぼーるばこ	段ボール箱
だんねつへんか	断熱変化
だんどうひこう	弾道飛行
だんていちょう	断定調
だんだんばたけ	段々畑	段段畑
だんたいりよう	団体利用
だんたいよやく	団体予約
だんたいほけん	団体保険
だんたいそうび	団体装備
だんたいきゃく	団体客
だんたいえんぎ	団体演技
だんそんじょひ	男尊女卑
だんぜんにんき	断然人気
だんせんちてん	断線地点
だんせいわしゃ	男性話者
だんせいふたり	男性二人
だんせいひょう	男性票
だんせいしんり	男性心理
だんせいしょし	男性諸子	男性諸氏
だんせいさべつ	男性差別
だんせいさっか	男性作家
だんせいきゃく	男性客
だんせいかしゅ	男性歌手
だんじょさべつ	男女差別
だんじょくべつ	男女区別
だんじょかくさ	男女格差
だんじょうだい	弾正台
だんじゅうろう	團十郎	団十郎
だんしょくけい	暖色系
だんしべんじょ	男子便所
だんしどうよう	男子同様
だんしすいちく	弾糸吹竹
だんししゃいん	男子社員
だんしこうこう	男子高校
だんしがくせい	男子学生
だんごうこうい	談合行為
だんけつりょく	団結力
だんきうんてん	暖気運転	暖機運転
だんかいせだい	団塊世代
だんいんしかく	団員資格
だんいしゅとく	段位取得
だんあつせいじ	弾圧政治
だつりょくかん	脱力感
だつもうしょう	脱毛症
だつほうこうい	脱法行為
だつさんそざい	脱酸素剤
だつごくしゅう	脱獄囚
だっぽうこうい	脱法行為
だっせんわだい	脱線話題
だっせんこうさ	脱線交差
だっすいどうさ	脱水動作
だっすいしょう	脱水症
だっすいしぼう	脱水死亡
だっすいこうか	脱水効果
だっしょくざい	脱色剤
だっしゅつほう	脱出法
だっしゅうざい	脱臭剤
だせいそうこう	惰性走行
だせいうんどう	惰性運動
だしゃそうしゃ	打者走者
だしまきたまご	出し巻き卵
だこうとうてい	打高投低
だげきとうしゅ	打撃投手
だげきせいせき	打撃成績
だえんうんどう	楕円運動
だいわぼうせき	大和紡績
だいわくじょう	台枠上
だいわぎんこう	大和銀行
だいろっきょく	第六局
だいろくせだい	第六世代
だいろくしあい	第六試合
だいりょういき	大領域
だいりゅうこう	大流行
だいりゅうけつ	大流血
だいりとうこう	代理投稿
だいりてんがわ	代理店側
だいりせんゆう	代理占有
だいりせんそう	代理戦争
だいりしつもん	代理質問
だいらくしょう	大楽勝
だいよんしょう	第4章	第四章
だいよんしあい	第四試合
だいよんきがく	第四紀学
だいよくじょう	大浴場
だいようりょう	大容量
だいようしょく	代用食
だいようかんじ	代用漢字
だいようかのう	代用可能
だいもんじやま	大文字山
だいもくみてい	題目未定
だいもくひょう	大目標
だいめいふめい	題名不明
だいめいきゅう	大迷宮
だいみょうじん	大明神
だいまるうめだ	大丸梅田
だいぼくじょう	大牧場
だいほうしゅつ	大放出
だいぶんるいか	大分類下
だいぶもんせい	大部門制
だいふくちょう	大福帳
だいふくちゅう	大腹中
だいびょうにん	大病人
だいびょういん	大病院
だいひんしゅく	大顰蹙
だいひょうれい	代表例
だいひょうめい	代表名
だいひょうばん	大評判
だいひょうてん	代表点
だいひょうてき	代表的
だいひょうだん	代表団
だいひょうしゃ	代表者
だいひょうさく	代表作
だいひょうこう	代表校
だいひょうげん	代表元	大氷原
だいひょうけん	代表権
だいひょうけい	代表型
だいひょうぐみ	代表組
だいひょうかく	代表格
だいばくしょう	大爆笑
だいはちしあい	第八試合
だいはちぐるま	大八車
だいはくりょく	大迫力
だいのうひしつ	大脳皮質
だいねっきょう	大熱狂
だいにゅうれい	代入例
だいにゅうぶん	代入文
だいにほうそく	第二法則
だいにのさんみ	大弐三位
だいにどうりん	第二動輪
だいにでんでん	第二電電
だいにちざかり	大日盛
だいにだんかい	第2段階
だいにせっけい	第二設計
だいにこくどう	第二国道
だいにけいひん	第二京浜
だいにいんすう	第二引数
だいなんじょう	第何条
だいななしあい	第七試合
だいななきょく	第七局
だいどころよう	台所用
だいどうみゃく	大動脈
だいどうけおり	大同毛織
だいとくしゅう	大特集
だいとうりょう	大統領
だいとうぶんか	大東文化
だいとうきょう	大東京
だいでんりょく	大電力
だいでんりゅう	大電流
だいちょうへん	大長編
だいちょうきん	大腸菌
だいちょうがん	大腸癌
だいちょうえん	大腸炎
だいちゅうだん	大中断
だいちゅうおう	台中央
だいだいひょう	大代表
だいたんふてき	大胆不敵
だいたいろせん	代替路線
だいたいぶひん	代替部品
だいたいふろん	代替フロン
だいたいどうろ	代替道路
だいたいこうか	代替効果
だいたいきかん	代替機関
だいそつだんし	大卒男子
だいそつじょし	大卒女子
だいそうじょう	大僧正	大僧上
だいそうしょう	大僧正
だいそうさせん	大捜査線
だいぜんしゅう	大全集
だいぜっきょう	大絶叫
だいせんりゃく	大戦略
だいせんきょく	大選挙区
だいせいりょく	大勢力
だいせいきょう	大盛況
だいすうみてい	台数未定
だいすうしよう	代数仕様
だいすうこうか	台数効果
だいすうかくほ	台数確保
だいじょきょく	大序曲
だいじょうだん	大上段
だいじょうさい	大嘗祭
だいじょうかん	太政官
だいじゅんかん	大循環
だいじゅうたい	大渋滞
だいじゃたいじ	大蛇退治
だいしょくどう	大食堂
だいしょうほう	大翔鳳
だいしょうとつ	大衝突
だいしょうてん	大賞典
だいしょうだい	大商大
だいしょうざん	大翔山
だいしょうぐん	大将軍
だいしょうがい	大障害
だいしゅつげん	大出現
だいしゅじゅつ	大手術
だいしゅうだん	大集団
だいしゅうしゃ	大衆車
だいしゅうごう	大集合
だいしゅうかく	大収穫
だいしゅうかい	大集会
だいしゃっきん	大借金
だいしへんけい	大四辺形
だいしぎんこう	第四銀行
だいさんぶたい	第三舞台
だいさんせだい	第三世代
だいさんせかい	第三世界
だいさんしょう	第3章	第三章
だいさんしあい	第三試合
だいさんこうざ	第三講座
だいさんきぼう	第三希望
だいごわくせい	第五惑星
だいごてんのう	醍醐天皇
だいごてってい	大悟徹底
だいこんおろし	大根下ろし
だいこくばしら	大黒柱
だいこくちょう	大国町
だいこうりょう	大光量
だいこうゆそう	代行輸送
だいこうひょう	大好評
だいこうぎょう	代行業
だいこうぎしつ	大講義室
だいげきじょう	大劇場
だいけんきゅう	大研究
だいぎんじょう	大吟醸
だいぎょうてん	大仰天
だいぎゃくてん	大逆転
だいぎゃくさつ	大虐殺
だいぎいんかい	代議員会
だいきょうまち	大京町
だいきょうそう	大競走
だいきょうすう	大凶数
だいきょうしつ	大教室
だいきょうこう	大恐慌
だいきょうかい	大教会
だいきぼとうし	大規模投資
だいきぼちしき	大規模知識
だいきぼかんり	大規模管理
だいがっしょう	大合唱
だいがくまんが	大学漫画
だいがくのーと	大学ノート
だいがくじだい	大学時代
だいがくこうざ	大学講座
だいがくがくぶ	大学学部
だいがくいこう	大学以降
だいがくいがい	大学以外
だいがえゆそう	代替輸送
だいかんしゅう	大観衆
だいかんごりん	大漢語林
だいかべんさい	代価弁済
だいかいじょう	大会場
だいかいじゅう	大怪獣
だいかいしょう	大海嘯
だいかいぎしつ	大会議室
だいおんりょう	大音量
だいおんじょう	大音声
だいおんきょう	大音響
だいおうじょう	大往生
だいえんじょう	大円上
だいいべんさい	代位弁済
だいいっしょう	第1章	第一章
だいいっしゅう	第一週
だいいっきゅう	第一級
だいいっかいめ	第１回目	第一回目
だいいちりゅう	第一流
だいいちようそ	第1要素
だいいちほてる	第一ホテル
だいいちにちめ	第一日目
だいいちしあい	第一試合
だいいちこうほ	第1候補	第一候補
だいいちこうざ	第一講座
だいいちげんり	第一原理
だいいちぎてき	第一義的
だいいちきぼう	第一希望
だいいちかもつ	第一貨物
だいあいじょう	大愛情
どんちゃんさわぎ	どんちゃん騒ぎ
どろぼうたいさく	泥棒対策
どれいしょうにん	奴隷商人
どぼくぎょうしゃ	土木業者
どにちしゅくじつ	土日祝日
どにちきゅうじつ	土日休日
どっぷらーこうか	ドップラー効果
どちゃくみんぞく	土着民族
どけんぎょうしゃ	土建業者
どくりつみんぞく	独立民族
どくりつへんすう	独立変数
どくりつだんたい	独立団体
どくりつたんてん	独立単点
どくりつせんそう	独立戦争
どくりつせんげん	独立宣言
どくりつじしょう	独立事象
どくりつしゃりん	独立車輪
どくりつさいさん	独立採算
どくりつきねんび	独立記念日
どくりつうんどう	独立運動
どくだんせんこう	独断専行
どくぜんけいこう	独善傾向
どくせんゆにゅう	独占輸入
どくせんはんばい	独占販売
どくせんけいやく	独占契約
どくせんきぎょう	独占企業
どくせいひょうか	毒性評価
どくせいじっけん	毒性実験
どくしんだんせい	独身男性
どくしんせいかつ	独身生活
どくしんじょせい	独身女性
どくしょさんとう	読書三到
どくしょけいこう	読書傾向
どくしゃとうこう	読者投稿
どくしゃぜんいん	読者全員
どくさいたいせい	独裁体制
どくさいせいけん	独裁政権
どくさいしゃせい	独裁者制
どきょういっぱつ	度胸一発
どうわこうぎょう	同和鉱業
どうわきょういく	同和教育
どうわがくしゅう	同和学習
どうろようりょう	道路容量
どうろへんちょう	道路偏重
どうろひょうしき	道路標識
どうろちゅうおう	道路中央
どうろせいびろん	道路整備論
どうろじょうほう	道路情報
どうろじゅうたい	道路渋滞
どうろぎょうせい	道路行政
どうろかんりしゃ	道路管理者
どうろかくちょう	道路拡張
どうりょくそうち	動力装置
どうりきがくてき	動力学的
どうらくはんぶん	道楽半分
どうめいひぎょう	同盟罷業
どうめいかんけい	同盟関係
どうみゃくりゅう	動脈瘤
どうみゃくちゅう	動脈中
どうみゃくじょう	動脈上
どうみゃくこうか	動脈硬化
どうほうつうしん	同報通信
どうぶつじっけん	動物実験
どうぶつしゃしん	動物写真
どうぶつがくしゃ	動物学者
どうぶつえんまえ	動物園前
どうぶつえんせん	動物園線
どうにゅうぶぶん	導入部分
どうにゅうじょう	導入上
どうにゅうしょき	導入初期
どうにゅうきそく	導入規則
どうにゅうかのう	導入可能
どうにゅうかいし	導入開始
どうにゅういぜん	導入以前
どうとくほうそく	道徳法則
どうとくてつがく	道徳哲学
どうとうほうめん	道東方面
どうとういじょう	同等以上
どうてきめいれい	動的命令
どうてきはいぶん	動的配分
どうてきそくばく	動的束縛
どうてきせいぎょ	動的制御
どうてきかいせき	動的解析
どうちょうとせつ	道聴塗説
どうちょうそうち	同調装置
どうちょうかいろ	同調回路
どうちゃくごほう	撞着語法
どうだいがくいん	同大学院
どうたいしりょく	動体視力	動態視力
どうぞくけいえい	同族経営
どうぞくがいしゃ	同族会社
どうそうかいほう	同窓会報
どうせいどうめい	同姓同名
どうせいけっこん	同性結婚
どうせいあいしゃ	同性愛者
どうじんしさっか	同人誌作家
どうじょうやぶり	道場破り
どうじょうみゃく	動静脈
どうじょうひょう	同情票
どうじたはつてき	同時多発的
どうじたはつせい	同時多発性
どうじじょうえい	同時上映
どうじしゅうろく	同時収録
どうじくかいてん	同軸回転
どうしゅりゅうし	同種粒子
どうしゅつしえん	導出支援
どうしゅつきそく	導出規則
どうしゅつかのう	導出可能
どうしゅつかてい	導出過程
どうしゅぞくかん	同種属間
どうしゃはっこう	同社発行
どうさりょういき	動作領域
どうさようでんち	動作用電池
どうさみかくにん	動作未確認
どうさじょうたい	動作状態
どうさじょうけん	動作条件
どうさかんきょう	動作環境
どうさかくにんご	動作確認後
どうこうちょうさ	動向調査
どうこういきょく	同工異曲
どうけいはんぷく	同型反復
どうけいどうだい	同形同大
どうけいたいおう	同型対応
どうけいしゃぞう	同型写像	同形写像
どうぎょうたしゃ	同業他社
どうぎていしゅつ	動議提出
どうきにゅうしゃ	同期入社
どうきしきしょり	同期式処理
どういつろうどう	同一労働
どういつほんすう	同一本数
どういつほうこう	同一方向
どういつへいめん	同一平面
どういつひんしつ	同一品質
どういつはんてい	同一判定
どういつないよう	同一内容
どういつちんぎん	同一賃金
どういつせいひん	同一製品
どういつじんぶつ	同一人物
どういつしょぞく	同一所属
どういつしゃめい	同一車名
どういつしゃしゅ	同一車種
どういつけいしき	同一形式
どういつけいえい	同一経営
どういたいこうか	同位体効果
どういけんたすう	同意見多数
どうあんふくすう	同案複数
でんわりようしゃ	電話利用者
でんわりょうきん	電話料金
でんわとうひょう	電話投票
でんわきほんたい	電話機本体
でんりょくりょう	電力量
でんりょくでんし	電力電子
でんりょくしせつ	電力施設
でんりゅうりょう	電流量
でんりゅうみつど	電流密度
でんりゅうへんか	電流変化
でんりゅうばくは	電流爆破
でんりゅうつうか	電流通過
でんりしょうとつ	電離衝突
でんぶんしょうこ	伝聞証拠
でんぶんけいしき	伝聞形式
でんぴょうしょり	伝票処理
でんぱんじかんさ	伝搬時間差
でんぱりようぜい	電波利用税
でんぱしょうねん	電波少年
でんぱしょうがい	電波障害
でんぱぎょうせい	電波行政
でんのうしゃかい	電脳社会
でんのうくうかん	電脳空間
でんねつかんけい	伝熱関係
でんどうはみがき	電動歯磨
でんとうりょうり	伝統料理
でんとうこうげい	伝統工芸
でんとうげいのう	伝統芸能
でんでんこうしゃ	電電公社
でんてつがいしゃ	電鉄会社
でんてついずもし	電鉄出雲市
でんつうだいいん	電通大院
でんちようりょう	電池容量
でんちゅうばおり	殿中羽織
でんたつほうしき	伝達方式
でんたつぶっしつ	伝達物質
でんたつとくせい	伝達特性
でんたつしゅだん	伝達手段
でんたつこうりつ	伝達効率
でんたつけいしき	伝達形式
でんたつかんすう	伝達関数
でんそうばいたい	伝送媒体
でんそうないよう	伝送内容
でんそうとくせい	伝送特性
でんそうたいいき	伝送帯域
でんそうせいぎょ	伝送制御
でんそうしゅだん	伝送手段
でんそうかんけい	電装関係
でんじりゅうたい	電磁流体
でんじはこうがく	電磁波工学
でんじてききろく	電磁的記録
でんじちょうりき	電磁調理器	電磁調理機
でんじしょうがい	電磁障害
でんじげんしょう	電磁現象
でんじかんきょう	電磁環境
でんしんはちごう	電信八号
でんしれいきゃく	電子冷却
でんしょうきょく	伝承曲
でんしゃへんせい	電車編成
でんしゃつうきん	電車通勤
でんしゃつうがく	電車通学
でんしゃせんよう	電車専用
でんしゃうんちん	電車運賃
でんしとしょかん	電子図書館
でんしせいぎょか	電子制御化
でんしじょうほう	電子情報
でんしじょうたい	電子状態
でんししゅっぱん	電子出版
でんしざいりょう	電子材料
でんしこうぎょう	電子工業
でんしこうがっか	電子工学科
でんしこうがくか	電子工学科
でんしけいじばん	電子掲示板
でんしけいさんき	電子計算機
でんしぎじゅつや	電子技術屋
でんしかいろがく	電子回路学
でんしかいぎしつ	電子会議室
でんしおんきょう	電子音響
でんこうほうしゃ	電光放射
でんこうひょうじ	電光表示
でんげんないぞう	電源内蔵
でんげんでんあつ	電源電圧
でんげんけんよう	電源兼用
でんげんかんけい	電源関係
でんげんかいはつ	電源開発
でんけんさんしゅ	電験三種
でんぎょうだいし	伝教大師
でんきれんけつき	電気連結器
でんきれいぞうこ	電気冷蔵庫
でんきりようしゃ	電気利用者
でんきりょうほう	電気療法
でんきりょうきん	電気料金
でんきようりょう	電気容量
でんきょくでんい	電極電位
でんきどうりょく	電気動力
でんきでんどうど	電気伝導度
でんきてきかいろ	電気的回路
でんきちゅうぞう	電気鋳造
でんきすいはんき	電気炊飯器
でんきじょうほう	電気情報
でんきじどうしゃ	電気自動車
でんきしょうせつ	伝奇小説
でんきさんぎょう	電器産業
でんきこうぎょう	電気工業
でんきこうがっか	電気工学科
でんきこうがくか	電気工学科
でんきけいがっか	電気系学科
でんききそこうざ	電気基礎講座
でんききかんしゃ	電気機関車	電機機関車
でんきおんすいき	電気温水器
でんきおんきょう	電気音響
でんかのほうとう	伝家の宝刀
でんかかんせいご	電化完成後
でんかかいぎょう	電化開業
でんかいきょうど	電界強度
でんかいかいせき	電界解析
でんえんふうけい	田園風景
でんえんとしせん	田園都市線
でんえんちょうふ	田園調布
でんあつへんどう	電圧変動
でまちやなぎえき	出町柳駅
ですくとっぷがた	デスクトップ型
でじたるほうそう	デジタル放送
でじたるしんごう	デジタル信号
でぐちちょくぜん	出口直前
でくれっしぇんど	decres	decrescendo
でーとしょうほう	デート商法
だんろんふうはつ	談論風発
だんねつせいのう	断熱性能
だんねつじっけん	断熱実験
だんどううんどう	弾道運動
だんちょうだいり	団長代理
だんたいわりびき	団体割引
だんたいりょこう	団体旅行
だんたいぜんたい	団体全体
だんたいせんよう	団体専用
だんたいこうどう	団体行動
だんたいけんきん	団体献金
だんたいきょうぎ	団体競技
だんたいうんちん	団体運賃
だんぞくせっさく	断続切削
だんぞくさつえい	断続撮影
だんそうしゃしん	断層写真
だんそうさつえい	断層撮影
だんぜんかくじつ	断然確実
だんせいせんよう	男性専用
だんせいしょこん	男性初婚
だんせいしゅたい	男性主体
だんせいしゃかい	男性社会
だんせいしゃいん	男性社員
だんせいさんらん	弾性散乱
だんせいさいこん	男性再婚
だんせいこういん	男性行員
だんじょもんだい	男女問題
だんじょどうけん	男女同権
だんじょこんせい	男女混成
だんじょこんざい	男女混在
だんじょこんごう	男女混合
だんじょこうさい	男女交際
だんじょけんよう	男女兼用
だんじょかんけい	男女関係
だんじょいったい	男女一体
だんじょいっしょ	男女一緒
だんしょうしゅぎ	断章取義
だんしゅせいさく	断種政策
だんしゃくふじん	男爵夫人
だんしけっしょう	男子決勝
だんごじょうたい	団子状態
だんこんすうはい	男根崇拝
だんがんれっしゃ	弾丸列車
だんがいぜっぺき	断崖絶壁
だんがいさいばん	弾劾裁判
だんかんれいぼく	断簡零墨
だんかいろしゅつ	段階露出
だんいんばんごう	団員番号
だんいほうしょく	暖衣飽食
だつもうほうほう	脱毛方法
だつさんしんりつ	奪三振率
だつさんしんすう	奪三振数
だつさんしんおう	奪三振王
だったいほうほう	脱退方法
だっすいはんのう	脱水反応
だっしゅつそくど	脱出速度
だっしふんにゅう	脱脂粉乳
だっかいさくせん	奪回作戦
だじょうだいじん	太政大臣
だじょうかんれい	太政官令
だじょうかんさつ	太政官札
だげきれんしゅう	打撃練習
だきょうていあん	妥協提案
だがしぎょうしゃ	駄菓子業者
だいわしょうけん	大和證券	大和証券
だいれんらくばし	大連絡橋
だいれきしじけん	大歴史事件
だいりとうひょう	代理投票
だいりしゅっさん	代理出産
だいよんわくせい	第四惑星
だいよんたんとう	第四担当
だいようりょうか	大容量化
だいようかんごく	代用監獄
だいゆうざんせん	大雄山線
だいもくひょうじ	題目表示
だいみんていこく	大明帝国
だいみょうやしき	大名屋敷
だいみょうどうし	大名同士
だいみょうおろし	大名下ろし
だいぼうねんかい	大忘年会
だいほうけんせつ	大豊建設
だいぶつべんさい	代物弁済
だいぶつかいがん	大仏開眼
だいひょうりゅう	大漂流
だいひょうでんわ	代表電話
だいひょうしょく	代表色
だいひょうしかく	代表資格
だいひょうこうほ	代表候補
だいひょうきょく	代表曲
だいひょうかんじ	代表幹事
だいはんもちゅう	大繁茂中
だいはちへんせい	第八編成
だいはくらんかい	大博覧会
だいはいきりょう	大排気量
だいのうへんえん	大脳辺縁
だいにりょうしか	第二量子化
だいにゅうそうさ	代入操作
だいにゅうげんご	代入言語
だいにゅうきそく	代入規則
だいにゅうかのう	代入可能
だいにほんかいが	大日本絵画
だいにちにょらい	大日如来
だいにすいじゅん	第二水準	第２水準	第2水準
だいにじたいせん	第二次大戦
だいにじぎょうぶ	第二事業部
だいにぎていしょ	第二議定書
だいにぎじゅつぶ	第二技術部
だいにぎじゅつか	第二技術課
だいにがくしょう	第二楽章
だいにがいこくご	第二外国語
だいにかいはつぶ	第二開発部
だいにかいはつか	第二開発課
だいなんしゅうめ	第何週目
だいなりいこーる	≧
だいどうだんけつ	大同団結
だいどうしょうい	大同小異
だいどうこうはん	大同鋼板
だいどうげいにん	大道芸人
だいとちしょゆう	大土地所有
だいとこうぎょう	大都工業
だいとうりょうふ	大統領府
だいとうがくえん	大東学園
だいでんつうだい	大電通大
だいちょうかんり	台帳管理
だいちゅうしょう	大中小
だいだほんるいだ	代打本塁打
だいたいほうほう	代替方法
だいたいひょうき	代替表記
だいたいしゅだん	代替手段
だいたいしっこう	代替執行
だいたいくうこう	代替空港
だいたいかいさい	代替開催
だいぞうかんごう	大増刊号
だいすうてきかい	代数的解
だいすうこうぞう	代数構造
だいすうけいとう	代数系統
だいすうきかてき	代数幾何的
だいすうきかがく	代数幾何学
だいすうがくしゃ	大数学者
だいすうかくだい	代数拡大
だいじんぐうした	大神宮下
だいじんかんぼう	大臣官房
だいじょうみゃく	大静脈
だいじょうきょう	大乗経
だいじょうかんぷ	太政官符
だいしょうりろん	代償理論
だいしょうひかく	大小比較
だいしょうくべつ	大小区別
だいしゅつりょく	大出力
だいしゅくしゃく	大縮尺
だいしゃふりかえ	台車振替
だいしゃこうかん	台車交換
だいしっせいかん	大執政官
だいさんしょかん	第三書館
だいさんしゃてき	第三者的
だいさんけいひん	第三京浜
だいさんがくぐん	第三学群
だいさんかいそう	第三階層
だいさんおうよう	第三応用
だいさんいんすう	第三引数
だいごらくえいが	大娯楽映画
だいごぶだいにか	第五部第二課
だいごぎじゅつか	第五技術課
だいこんやくしゃ	大根役者
だいこうもくめい	大項目名
だいこうぼうせん	大攻防戦
だいこうだいこう	大工大高
だいこうぎょうむ	代行業務
だいきょうちょう	大京町
だいきぼへいれつ	大規模並列
だいきぼはつでん	大規模発電
だいきぼこうぞう	大規模構造
だいきぼけいさん	大規模計算
だいがくやきゅう	大学野球
だいがくふんそう	大学紛争
だいがくにゅうし	大学入試
だいがくたいこう	大学対抗
だいがくぜんぱん	大学全般
だいがくぜんたい	大学全体
だいがくせいかつ	大学生活
だいがくじょしゅ	大学助手
だいがくじゅけん	大学受験
だいがくしんがく	大学進学
だいがくしょりん	大学書林
だいがくしょてん	大学書店
だいがくこうない	大学構内
だいがくかんけい	大学関係
だいがくかいかん	大学会館
だいがくいんせい	大学院生
だいがくいがくぶ	大学医学部
だいがえくうこう	代替空港
だいかんわじてん	大漢和辞典	大漢和辭典
だいかんみんこく	大韓民国
だいかんのんぞう	大観音像
だいかんこうくう	大韓航空
だいかんげいかい	大歓迎会
だいかんきょほう	大艦巨砲
だいえいていこく	大英帝国
だいいっしゅうめ	第一週目
だいいちよういん	第一要因
だいいちゆうせん	第一優先
だいいちほんごく	第一本国
だいいちほうそく	第一法則
だいいちひきすう	第一引数
だいいちにんしゃ	第一人者
だいいちどうりん	第一動輪
だいいちちょしゃ	第一著者
だいいちだんかい	第1段階	第一段階
だいいちせめんと	第一セメント
だいいちせっけい	第一設計
だいいちせいやく	第一製薬
だいいちせいめい	第一生命
だいいちじよせん	第一次予選
だいいちけいひん	第一京浜
だいいちかんぎん	第一勧銀
だいいちかいそう	第一階層
だいいちおうよう	第一応用
どんぶりかんじょう	丼勘定
どりょくもくひょう	努力目標
どようびしゅっぱつ	土曜日出発
どぼくさぎょうよう	土木作業用
どひょうちゅうおう	土俵中央
どっきょうだいがく	独協大学
どっかいのうりょく	読解能力
どくりつせいりょく	独立勢力
どくりつしゅうごう	独立集合
どくりつぐれんたい	独立愚連隊
どくりつぎゆうぐん	独立義勇軍
どくりつきねんかん	独立記念館
どくそうじょうたい	独走状態
どくせんじょうたい	独占状態
どくせんじゅしょう	独占授賞
どくせんきんしほう	独占禁止法
どくしょしょうがい	読書障害
どくしょしゅうかん	読書週間
どくしょこんなんじ	読書困難児
どくしゃとうひょう	読者投票
どくしゃたいしょう	読者対象
どくしゃしょうたい	読者招待
どくさいしゅぎしゃ	独裁主義者
どくごかんそうぶん	読後感想文
どくぐんこうくうき	独軍航空機
どうろじょうきょう	道路状況
どうろじじょうなど	道路事情等
どうろこうつうほう	道路交通法
どうるいがっちゃく	同類合着
どうりょくだいしゃ	動力台車
どうりょくせいのう	動力性能
どうりょうじょうし	同僚上司
どうりつゆうしょう	同率優勝
どうめいきゅうこう	同盟休校
どうみゃくさいけつ	動脈採血
どうまさつけいすう	動摩擦係数	動摩擦系数
どうぶつびょういん	動物病院
どうぶつちゅうしん	動物中心
どうぶつぎゃくたい	動物虐待
どうふけんみんぜい	道府県民税
どうにゅうほうほう	導入方法
どうにゅうとうしょ	導入当初
どうとくてきけんち	道徳的見地
どうとくきょういく	道徳教育
どうてんけっしょう	同点決勝
どうそうかいめいぼ	同窓会名簿
どうじんしけっさく	同人誌傑作
どうじんしかつどう	同人誌活動
どうじょうしゃよう	同乗者用
どうじはつおんすう	同時発音数
どうじにゅうりょく	同時入力
どうじしんこうてき	同時進行的
どうじしんこうせい	同時進行性
どうじしんこうけい	同時進行形
どうしんえんじょう	同心円状	同心円上
どうしょくぶつめい	動植物名
どうししゃだいがく	同志社大学
どうさてきもんだい	動作的問題
どうさじょうきょう	動作状況
どうさしゅつりょく	動作出力
どうさかくにんよう	動作確認用
どうこうほうじょう	道交法上
どうこうほういはん	道交法違反
どうけんきゅうしつ	同研究室
どうぎてきせきにん	道義的責任
どうきょじゅうにん	同居住人
どうきちょうそうき	同期調相機
どうきしゅうはすう	同期周波数
どうきしきてんそう	同期式転送
どうかんじいおんご	同漢字異音語
どうおんくんひょう	同音訓表
どういつりょうきん	同一料金
どういつりょういき	同一領域
どういつせんじょう	同一線上
どういつじょうけん	同一条件
どういつしゅうかい	同一周回
どういつきょくめん	同一局面
どういつきょうそう	同一競走
どういそうしゃぞう	同位相写像
でんわれんらくもう	電話連絡網
でんわよやくかいし	電話予約開始
でんわだいせつやく	電話代節約
でんわしようけんり	電話使用権利
でんわかにゅうけん	電話加入権
でんりょくはいせん	電力配線
でんりょくじゅよう	電力需要
でんりょくしょうひ	電力消費
でんりょくけいとう	電力系統
でんりょくがいしゃ	電力会社
でんりょくかんけい	電力関係
でんりゅういってい	電流一定
でんぶんじょうほう	伝聞情報
でんぱんはせいぶん	伝搬波成分
でんぱんじかんとう	伝搬時間等
でんぱりようりょう	電波利用料
でんぱむきょうしつ	電波無響室
でんぱてんもんがく	電波天文学
でんぱじょうきょう	電波状況
でんぱしんぶんしゃ	電波新聞社
でんぱしようりょう	電波使用料
でんぱかんりきょく	電波管理局
でんのうゆうえんち	電脳遊園地
でんのうどうぐばこ	電脳道具箱
でんのうかしゃかい	電脳化社会
でんどうじてんしゃ	電動自転車
でんどうあわたてき	電動泡立て器
でんとうてきせいど	伝統的制度
でんとうしゅうかん	伝統習慣
でんちしきでんげん	電池式電源
でんせんちちゅうか	電線地中化
でんじょうはいこう	電場配向
でんじほうていしき	電磁方程式
でんじはざんりゅう	電磁波残留
でんじきえんしゅう	電磁気演習
でんしょうぶんがく	伝承文学
でんしょうじょじし	伝承叙事詩
でんしゃとっきゅう	電車特急
でんしゃせんせつび	電車線設備
でんしゃきゅうこう	電車急行
でんしつうしんがく	電子通信学
でんしこうさくよう	電子工作用
でんしけんびきょう	電子顕微鏡
でんしぎじゅつしゃ	電子技術者
でんさんしゃしょく	電算写植
でんこうけいじばん	電光掲示盤	電光掲示板
でんげんようりょう	電源容量	電原容量
でんげんとうにゅう	電源投入
でんきでんしぶんや	電気電子分野
でんきてきとくせい	電気的特性
でんきてきかつどう	電気的活動
でんきつうしんだい	電気通信大
でんきじぎょうほう	電気事業法
でんきしようりょう	電気使用量
でんきしゅうじんき	電気集塵器
でんきこうがくしゃ	電気工学者
でんきこうがくけい	電気工学系
でんきけんそくしゃ	電気検測車
でんきけいそくがく	電気計測学
でんきききせいさく	電気機器製作
でんきききこうがく	電気機器工学
でんきかいろぶぶん	電気回路部分
でだまじょうきょう	出玉状況
でぐちおにさぶろう	出口王仁三郎
だんやくちょぞうこ	弾薬貯蔵庫
だんぺんてきちしき	断片的知識
だんたにさんぎょう	段谷産業
だんたいりょうきん	団体料金
だんたいこうしょう	団体交渉
だんたいきゃくよう	団体客用
だんせいりょうきん	男性料金
だんせいしゃしょう	男性車掌
だんせいがっしょう	男声合唱
だんじょびょうどう	男女平等
だんじょけっしょう	男女決勝
だんしようちえんじ	男子幼稚園児
だんがんとっきゅう	弾丸特急
だつせぞくしゃかい	脱世俗社会
だっしゅつほうほう	脱出方法
だっしゅつふかのう	脱出不可能
だっしゅつちょくご	脱出直後
だっしゅつしゅだん	脱出手段
だじょうかんふこく	太政官布告
だじょうかんにっし	太政官日誌
だげきかんりょうご	打撃完了後
だけんきょうじゃく	打鍵強弱
だきょうじょうけん	妥協条件
だえんきどうじょう	楕円軌道上
だいれんらくきょう	大連絡橋
だいりょうふくせい	大量複製
だいりとうこうぶん	代理投稿分
だいりてんてんとう	代理店店頭
だいりそうごさよう	代理相互作用
だいよんかいはつぶ	第四開発部
だいよんかいきゅう	第四階級
だいみょうりょこう	大名旅行
だいひょうちょしゃ	代表著者
だいひょうそしょう	代表訴訟
だいひょうせんしゅ	代表選手
だいひょうしゃかい	代表者会
だいひょうしゃいん	代表社員
だいひょうさんこま	代表産駒
だいひょうさくひん	代表作品
だいばめんせってい	大場面設定
だいはなびたいかい	大花火大会
だいはつこうぎょう	ダイハツ工業
だいのうはんきゅう	大脳半球
だいにゅうぶんぽう	代入文法
だいにゅうえんざん	代入演算
だいにほんていこく	大日本帝国
だいにほんいんさつ	大日本印刷
だいにたいいくかん	第２体育館
だいにせっけいしつ	第二設計室
だいにじさんぎょう	第二次産業
だいにしゅげんつき	第二種原付
だいにかいはつしつ	第二開発室
だいどころせんざい	台所洗剤
だいどころじじょう	台所事情
だいどうしょうにん	大道商人
だいとくじなっとう	大徳寺納豆
だいとくしゅうごう	大特集号
だいとうぼうしょく	大東紡織
だいとうぶんかだい	大東文化大
だいとうさいいきき	大唐西域記
だいとういつりろん	大統一理論
だいとうあせんそう	大東亜戦争
だいちゅうぶんるい	大中分類
だいだんあつじだい	大弾圧時代
だいたいひょうげん	代替表現
だいたいねんりょう	代替燃料
だいたいえねるぎー	代替エネルギー
だいすうてきしよう	代数的仕様
だいすうたようたい	代数多様体
だいすうきょくせん	代数曲線
だいじょうだいじん	太政大臣
だいじょうかんさつ	太政官札
だいじゅういっこう	第十一項
だいしょうわせいし	大昭和製紙
だいしょうかんけい	大小関係
だいしゅうそうぞく	代襲相続
だいさんせっけいか	第三設計課
だいさんせいりょく	第三勢力
だいさんすいじゅん	第三水準
だいさんしゃきかん	第三者機関
だいさんさいむしゃ	第三債務者
だいさんがくしょう	第三楽章
だいさんがいこくご	第三外国語
だいさんかいはつぶ	第三開発部
だいさんかいはつか	第三開発課
だいこんせんもよう	大混戦模様
だいこうかいじだい	大航海時代
だいげんすいへいか	大元帥陛下
だいけんしゅうしつ	大研修室
だいけんこうぎょう	大建工業
だいぎいんたいかい	代議員大会
だいきんこうぎょう	ダイキン工業
だいきょうかんこう	大京観光
だいきぎょうびょう	大企業病
だいがんじょうじゅ	大願成就
だいがめんたいおう	大画面対応
だいがくびょういん	大学病院
だいがくにゅうがく	大学入学
だいがくにほんいち	大学日本一
だいがくとしょかん	大学図書館
だいがくそつぎょう	大学卒業
だいがくせいゆうり	大学生有利
だいがくせいじょし	大学生女子
だいがくせいじだい	大学生時代
だいがくせいきょう	大学生協
だいがくしょねんじ	大学初年次
だいがくさいちゅう	大学祭中
だいがくきょうよう	大学教養
だいがくきょうじゅ	大学教授
だいがくきょうかん	大学教官
だいがくきょういん	大学教員
だいがくきょういく	大学教育
だいがくきそこうざ	大学基礎講座
だいかんじょうせん	大環状線
だいかんこうくうき	大韓航空機
だいかつやくちゅう	大活躍中
だいいっせんきゅう	第一線級
だいいっかいろんり	第一階論理
だいいちもくてきち	第一目的地
だいいちぶんがくぶ	第一文学部
だいいちにんしょう	第一人称
だいいちとうじしゃ	第一当事者
だいいちせっけいぶ	第一設計部
だいいちせっけいか	第一設計課
だいいちすいじゅん	第一水準	第1水準
だいいちじょしこう	第一女子高
だいいちじたいせん	第一次大戦
だいいちじしめきり	第一次締切
だいいちしょうたい	第一小隊
だいいちしょうけん	第一證券
だいいちこうしょう	第一興商
だいいちぎじゅつぶ	第一技術部
だいいちぎじゅつか	第一技術課
だいいちがくしょう	第一楽章
だいいちかいはつぶ	第一開発部
だいいちかいはつか	第一開発課
だいいちかいぎしつ	第一会議室
だいいちいんしょう	第一印象
どんかくさんかくけい	鈍角三角形
どっかいりょくぶそく	読解力不足
どせきりゅうはっせい	土石流発生
どくりつだいがくいん	独立大学院
どくりつじゅうそしき	独立柔組織
どくりつじぎょうしゃ	独立事業者
どくりつさいさんせい	独立採算制
どくぜんてきけいこう	独善的傾向
どくせんしほんしゅぎ	独占資本主義
どくしんせいかつしゃ	独身生活者
どくしょかんそうぶん	読書感想文
どうわちくじゅうみん	同和地区住民
どうろほしゅうよさん	道路補修予算
どうりんかいてんすう	動輪回転数
どうりょくかっくうき	動力滑空機
どうみゃくけっちゅう	動脈血中
どうぶつこうどうがく	動物行動学
どうぶつこうえんせん	動物公園線
どうはんきょうぎしゃ	同伴競技者
どうにゅうちょくぜん	導入直前
どうにゅうきょういく	導入教育
どうないじこくひょう	道内時刻表
どうとくてきそんげん	道徳的尊厳
どうてきふかぶんさん	動的負荷分散
どうてきけいかくほう	動的計画法
どうてききおくかんり	動的記憶管理
どうちょうせいちょう	同調生長
どうちょうきょくせん	同調曲線
どうじょうだいにこう	同条第二項
どうじてんとうぼうし	同時点灯防止
どうじそうしんかのう	同時送信可能
どうしょうかいりょう	道床改良
どうしゅりゅうしせい	同種粒子性
どうさけいぞくじかん	動作継続時間
どうこうかいぜんたい	同好会全体
どうきゅうせいどうし	同級生同士
どうきてんそうそくど	同期転送速度
どういつせいほじけん	同一性保持権
どういつしゅうはすう	同一周波数
どういつしゃせんない	同一車線内
どういつけいしきない	同一形式内
でんわよやくうけつけ	電話予約受付
でんわばんごうひょう	電話番号表
でんわこうかんきょく	電話交換局
でんりょくへんかんき	電力変換器
でんりょくぎょうかい	電力業界
でんりゅうようりょう	電流容量
でんぱつうしんがっか	電波通信学科
でんばほうれいしゅう	電波法令集
でんのうけんちくがく	電脳建築学
でんてつりようきゃく	電鉄利用客
でんちざんりょうけい	電池残量計
でんたつかんすうもぎ	伝達関数模擬
でんそうかいじょしゃ	電装解除車
でんしゃつうきんしゃ	電車通勤者
でんしゃせんでんあつ	電車線電圧
でんしばいたいじょう	電子媒体上
でんしてきへんしゅう	電子的編集
でんしつうしんじだい	電子通信時代
でんしつうしんがっか	電子通信学科
でんしせいぎょきかい	電子制御機械
でんしじょうほうつう	電子情報通
でんしじょうほうけい	電子情報系
でんししょうとりひき	電子商取引
でんしけんきゅうしょ	電子研究所
でんしけいさんきしつ	電子計算機室
でんしぎじゅつぶんや	電子技術分野
でんしききじぎょうぶ	電子機器事業部
でんこうひょうじばん	電光表示板
でんげんとうにゅうじ	電源投入時
でんげんとうにゅうご	電源投入後
でんげんしゅつりょく	電源出力
でんげんしゅうはすう	電源周波数
でんげんきょうきゅう	電源供給
でんきてきしょうげき	電気的衝撃
でんきつうしんがくぶ	電気通信学部
でんきじょうほうけい	電気情報系
でんきしきちくおんき	電気式蓄音機
でんきこうがくだいに	電気工学第二
でんきがっかいぎほう	電気学会技報
でんきおんきょうがく	電気音響学
でんきあつりょくなべ	電気圧力鍋
でんえんちょうふせん	田園調布線
でんえんちょうふえき	田園調布駅
でまちやなぎほうめん	出町柳方面
でおきしりぼかくさん	デオキシリボ核酸
だんめんゆそうりょう	断面輸送量
だんたいこうどうけん	団体行動権
だんぞくへいこうせつ	断続平衡説
だんそんじょひしゅぎ	男尊女卑主義
だんせいけしょうひん	男性化粧品
だんせいきつえんしゃ	男性喫煙者
だんじょべつへんせい	男女別編成
だんじょそうほうむき	男女双方向
だんしちゅうがくせい	男子中学生
だんがいさいばんしょ	弾劾裁判所
だんいにんていしょう	段位認定証
だっすいしょうじょう	脱水症状
だざいふてんまんぐう	太宰府天満宮
だがっきせんもんてん	打楽器専門店
だいよんきょうわせい	第四共和制
だいよんかんひょうき	第四間氷期
だいみょうじゅうぞく	大名従属
だいみょうぎょうれつ	大名行列
だいひょういいんかい	代表委員会
だいはんたいうんどう	大反対運動
だいはいきりょうしゃ	大排気量車
だいのうへんえんけい	大脳辺縁系
だいにゅうかのうせい	代入可能性
だいにゅうえんざんし	代入演算子
だいにっぽんていこく	大日本帝国
だいにっぽんいんさつ	大日本印刷
だいにじょうばんせん	第二常磐線
だいにけんきゅうしつ	第二研究室
だいにうちゅうそくど	第二宇宙速度
だいとうきょうかさい	大東京火災
だいちゅうしょくかい	大昼食会
だいちゅうしゃじょう	大駐車場
だいすうほうていしき	代数方程式
だいじょうぶっきょう	大乗仏教
だいじょうかんふこく	太政官布告
だいじょうかんにっし	太政官日誌
だいじょうかんちょう	太政官庁	太政官牒
だいさんしゅとくしゃ	第三取得者
だいさんしゃわりあて	第三者割当
だいさんしゃつうしん	第三者通信
だいさんがくぐんまえ	第三学群前
だいさんかいはつしつ	第三開発室
だいごせだいけいかく	第五世代計画
だいこうけいぼうえん	大口径望遠
だいこうきょうきょく	大交響曲
だいぎゃくさつじけん	大虐殺事件
だいがくやきゅうかい	大学野球界
だいがくせんしゅけん	大学選手権
だいがくごうかくりつ	大学合格率
だいがくきょうようぶ	大学教養部
だいがくかんけいしゃ	大学関係者
だいがくいんにゅうし	大学院入試
だいがくいんだいがく	大学院大学
だいがくいんざいがく	大学院在学
だいがくいんがくせい	大学院学生
だいがくいちねんせい	大学一年生
だいかんみんこくせき	大韓民国籍
だいかんみんこくじん	大韓民国人
だいかいぞうけいかく	大改造計画
だいえいはくぶつかん	大英博物館
だいいとくみょうおう	大威徳明王
だいいっししゅっさん	第一子出産
だいいっかいはいほん	第一回配本
だいいっかいちょうさ	第一回調査
だいいちせっけいしつ	第一設計室
だいいちかいはつしつ	第一開発室
どぼくこうぞうかいせき	土木構造解析
どぼくけんせつこうがく	土木建設工学
どにちしゅくじついがい	土日祝日以外
どくがんりゅうまさむね	独眼竜政宗
どうわたいさくじぎょう	同和対策事業
どうりょくでんたつけい	動力伝達系
どうりょくしゅうちゅう	動力集中
どうぶつだいぜんしゅう	動物大全集
どうぶつあいごだんたい	動物愛護団体
どうてきくうりきそうち	動的空力装置
どうじんしそくばいかい	同人誌即売会
どうじせいきぎょうれつ	同時生起行列
どうしゅつけいていぎぶ	導出系定義部
どうけいほうしゃそしき	同形放射組織
どうがあっしゅくきかく	動画圧縮規格
どういつへんせいちゅう	同一編成中
どういつとうひょうしゃ	同一投票者
でんわばんごうかくにん	電話番号確認
でんわばんごうあんない	電話番号案内
でんりょくきょうきゅう	電力供給
でんぱきゅうしゅうたい	電波吸収体
でんぱきゅうしゅうざい	電波吸収材
でんとうてきしゅうかん	伝統的習慣
でんたつかんすうしょり	伝達関数処理
でんしんでんわがいしゃ	電信電話会社
でんしれいきじょうたい	電子励起状態
でんしゃとくていくかん	電車特定区間
でんしつうしんがっかい	電子通信学会
でんしじょうほうがっか	電子情報学科
でんししゅっぱんきょく	電子出版局
でんしこうがくせんこう	電子工学専攻
でんしぎじゅつかんけい	電子技術関係
でんしきていじょうたい	電子基底状態
でんきふきゅうざいだん	電気普及財団
でんきつうしんほうしき	電気通信方式
でんきつうしんだいがく	電気通信大学
でんきつうしんじぎょう	電気通信事業
でんきせいひんいっぱん	電気製品一般
でんきこうがくせんこう	電気工学専攻
でんきこうがくじっけん	電気工学実験
でんきがっかいせいいん	電気学会正員
でんきかぶしきがいしゃ	電気株式会社
でんおんけいなんちょう	伝音系難聴
でんえんちょうふふたば	田園調布雙葉	田園調布双葉
でんえんこうきょうがく	田園交響楽
だんちがいへいこうぼう	段違い平行棒
だんたいりょこうきゃく	団体旅行客
だんたいこうしょうけん	団体交渉権
だんせいがっしょうだん	男声合唱団
だっすいしゅうりょうじ	脱水終了時
だっしゅつりんかいてん	脱出臨界点
だくおんにゅうりょくご	濁音入力後
だいりてんてすうりょう	代理店手数料
だいまるとうきょうてん	大丸東京店
だいほんえいはっぴょう	大本営発表
だいひょうてきめいばん	代表的名盤
だいひょうてきさくひん	代表的作品
だいにとうめいめいしん	第二東名
だいにすいじゅんちゅう	第二水準中
だいにすいじゅんかんじ	第二水準漢字
だいにじせかいたいせん	第二次世界大戦
だいにけいひんこくどう	第二京浜国道
だいとうりょうせんきょ	大統領選挙
だいとうぶんかだいがく	大東文化大学
だいしゅつりょくきょく	大出力局
だいさんけんきゅうしつ	第三研究室
だいこんらんじょうたい	大混乱状態
だいぎゃくてんしょうり	大逆転勝利
だいきぼすうちけいさん	大規模数値計算
だいがくろうにんちゅう	大学浪人中
だいがくびょういんまえ	大学病院前
だいがくたいざいちゅう	大学滞在中
だいがくそつぎょうしゃ	大学卒業者
だいがくざいがくちゅう	大学在学中
だいがくきかいほんやく	大学機械翻訳
だいがくいんきょういく	大学院教育
だいがくいちねんていど	大学一年程度
だいいちじかいぎょうじ	第一次開業時
だいいちしんどうりょく	第一震動力
だいいちけんきゅうしつ	第一研究室
だいいちうちゅうそくど	第一宇宙速度
どくりつちゅうおうたいざ	独立中央胎座
どくそうてきはっそうほう	独創的発想法
どくそうきょくぜんしゅう	独奏曲全集
どくさいしゅぎきょういく	独裁主義教育
どうろへんちょうせいさく	道路偏重政策
どうろうんそうしゃりょう	道路運送車両
どうりょくでんたつそうち	動力伝達装置
どうぶつあいごきょうかい	動物愛護協会
どうないばんじこくひょう	道内版時刻表
どうとくけいじじょうがく	道徳形而上学
どうじじっこうとうかせい	同時実行透過性
どうじしゅつりょくかのう	同時出力可能
どうさかんきょうせってい	動作環境設定
どうさかくにんじょうほう	動作確認情報
どうこうほうてきようがい	道交法適用外
どういつしょうてんきょり	同一焦点距離
どうあいきねんびょういん	同愛記念病院
でんりょくしょうひりょう	電力消費量
でんぱほうれいしょうろく	電波法令抄録
でんぱてきあくじょうけん	電波的悪条件
でんつうだいだいがくいん	電通大大学院
でんせんびょうよぼうほう	伝染病予防法
でんしてきじょうほうげん	電子的情報源
でんしじょうほうこうがく	電子情報工学
でんしこうがくきょうしつ	電子工学教室
でんこうかぶしきがいしゃ	電工株式会社
でんきつうしんざいりょう	電気通信材料
でんきじょうほうこうがく	電気情報工学
でんきけんていきょうかい	電気検定協会
でんえんこうきょうきょく	田園交響曲
だんそんじょひしゅぎしゃ	男尊女卑主義者
だんせいようけしょうひん	男性用化粧品
だんじょりょうきんかくさ	男女料金格差
だんじょどういつちんぎん	男女同一賃金
だんかいてきしょうさいか	段階的詳細化
だいりょうはいきしゃかい	大量廃棄社会
だいようりょうしゅうでん	大容量集電
だいひょうとりしまりやく	代表取締役
だいひょうでんわばんごう	代表電話番号
だいとうあきょうえいけん	大東亜共栄圏
だいさんしゅゆうびんぶつ	第三種郵便物
だいきんひきかえゆうびん	代金引換郵便
だいきぼぶんさんこうぞう	大規模分散構造
だいがくにゅうしもんだい	大学入試問題
だいがくてんもんれんめい	大学天文連盟
だいがくそつぎょうていど	大学卒業程度
だいがくそつぎょういらい	大学卒業以来
だいがくせいきょういがい	大学生協以外
だいがくじゅんきょうじゅ	大学准教授
だいがくじゅけんあんない	大学受験案内
だいがくきょうようていど	大学教養程度
だいがくいんせいたいかい	大学院生大会
だいがくいんじゅうてんか	大学院重点化
だいがくいんしんがくりつ	大学院進学率
だいいちれいきじょうたい	第一励起状態
だいいちじせかいたいせん	第一次世界大戦
だいいちけいひんこくどう	第一京浜国道
どくりつぎょうせいほうじん	独立行政法人
どうりょくぶんさんほうしき	動力分散方式
どうしょくぶつけんえきぜい	動植物検疫税
どうぎょうしゅきぎょうかん	同業種企業間
でんりょくちょぞうしゅだん	電力貯蔵手段
でんりょくけいとうこうがく	電力系統工学
でんつうこくさいじょうほう	電通国際情報
でんげんとうにゅうちょくご	電源投入直後
でんきじょうほうこうがっか	電気情報工学科
だいそうげんのちいさないえ	大草原の小さな家
だいがくいんしゅうりょうご	大学院修了後
だいいっかいじゅしょうしゃ	第一回受賞者
だいいちかんぎょうぎんこう	第一勧業銀行
どくりつこっかきょうどうたい	独立国家共同体
どうぶつあいじょうものがたり	動物愛情物語
どうじょうけんどうりょうきん	同条件同料金
でんりょくきょうきゅうりょく	電力供給力
でんきつうしんざいりょうがく	電気通信材料学
でんきつうしんけんきゅうじょ	電気通信研究所
でんきつうしんけんきゅうしょ	電気通信研究所
だいにっぽんていこくけんぽう	大日本帝国憲法
だいななげいじゅつげきじょう	第七芸術劇場
だいがくせいきょうしょくどう	大学生協食堂
だいがくいんきょうかんかいぎ	大学院教官会議
でんきおんきょうけんきゅうかい	電気音響研究会
だいがくいんきょういくたいこう	大学院教育大綱
でんしじょうほうつうしんがっかい	電子情報通信学会
でんしじょうほうこうがくせんこう	電子情報工学専攻
だいがくうちゅうたんさきょうかい	大学宇宙探査協会
でんしぎじゅつそうごうけんきゅうしょ	電子技術総合研究所
