ぽ	歩	舗	舖
ぷ	布	腐
ぴ	日
ぱ	張	播	波	羽	破
ぽん	椪	本
ぽつ	・
ぽち	・
ぽう	報	方	法	砲	包	烹
ぺん	邊	辺	邉	片
ぺた	peta
ぺけ	×
ぺき	北
ぺえ	北
ぺい	蔽	平	閇	閉	併	北
ぷん	分
ぷう	風
ぴん	筒	品
ぴつ	泌
ぴこ	pico
ぴき	匹
ぱん	播	板	幇	搬	版	麺麭
ぱり	巴里
ぱつ	発	發
ぱち	八
ぱこ	箱
ぱく	愽	博	泊	駮	朴	拍	パク
ぱお	包
ぱい	π	杯	牌	Π	敗	盃	配
ぽんび	ぽん引
ぽんど	£	磅
ぽんず	ポン酢
ぺるー	祕魯	祕露
ぺきん	北京
ぺえじ	頁
ぺいじ	頁
ぺーじ	頁
ぷらす	＋
ぷさん	釜山
ぴんふ	平和
ぴんず	筒子
ぴょう	票	憑
ぴっぷ	比布
ぴざや	ピザ屋
ぴあの	piano
ぴーは	Ｐ波
ぱんや	パン屋
ぱんこ	パン粉
ぱにく	パニク
ぱなま	巴奈馬
ぱおず	包子
ぽんぷざ	ポンプ座
ぽんびき	ぽん引き	ポン引き
ぽんちえ	ポンチ絵
ぽんかん	椪柑
ぽっとで	ぽっと出
ぽいすて	ポイ捨て
ぺんじく	ペン軸
ぺんさき	ペン先
ぺるしあ	波斯
ぺてんし	ペテン師
ぺっとや	ペット屋
ぺけぺけ	××
ぺきんご	北京語
ぷんまえ	分前
ぷんはん	分半
ぷんかん	分間
ぷろそう	プロ相
ぷろしあ	普魯西
ぷらまい	±
ぴんはね	ピン撥ね
ぴんあん	平安
ぴかいち	光一
ぴーたん	皮蛋
ぴーくじ	ピーク時
ぱんきじ	パン生地
ぱりっこ	パリっ子
ぱりさい	パリ祭
ぱぱさん	パパさん
ぱそつう	パソ通
ぱすめい	パス名
ぱすたや	パスタ屋
ぱぎょう	パ行	ぱ行
ぱいぷや	ぱいぷ屋
ぱいぱん	白板
ぱいきじ	パイ生地
ぱあそう	八索
ぱーみる	‰
ぽろにうむ	Po	Polonium
ぽるとがる	葡萄牙
ぽりぶくろ	ポリ袋
ぽちぶくろ	ぽち袋
ぽーらんど	波蘭
ぺとりさら	ペトリ皿
ぺすときん	ペスト菌
ぺがすすざ	ペガスス座
ぺがさすざ	ペガサス座
ぺーじすう	頁数	ページ数
ぷろぺらき	プロペラ機
ぴんくいろ	ピンク色
ぴろりきん	ピロリ菌
ぴりんけい	ピリン系
ぴょんやん	平壌
ぴあのせん	ピアノ線
ぱるすはば	パルス幅
ぱらじうむ	Pd	Palladium
ぱちんこや	パチンコ屋
ぱいぷやく	パイプ役
ぱいちゅー	白酒
ぱーせんと	％
ぽんとちょう	先斗町
ぽるとがるご	ポルトガル語
ぽいんとせい	ポイント制
ぽいんたがた	ポインタ型
ぺんぺんぐさ	ぺんぺん草
ぺるせうすざ	ペルセウス座
ぺるしゃわん	ペルシャ湾
ぺきんだっく	北京ダック
ぷんぴつえき	分泌液
ぷろやきゅう	プロ野球
ぷろめちうむ	Promethium	Pm
ぷろせすかん	プロセス間
ぷれいちゅう	プレイ中
ぷるとにうむ	Plutonium	Pu
ぷらせおじむ	Praseodymium	Pr
ぷらすようそ	プラス要素
ぷらすしこう	プラス思考
ぴんぽんだま	ピンポン玉
ぴるびんさん	ピルビン酸
ぴあのきょく	ピアノ曲
ぴあにっしも	pianissimo
ぱらふぃんし	パラフィン紙
ぱちんこだま	パチンコ玉
ぱちんこだい	パチンコ台
ぽりぺぷちどさ	ポリペプチド鎖
ぽっくりびょう	ぽっくり病
ぺきんにっぽう	北京日報
ぺきんげんじん	北京原人
ぺーじばんごう	ページ番号
ぷりんときばん	プリント基板
ぷらすよういん	プラス要因
ぷらすまいなす	±
ぷらすあるふぁ	プラスα
ぴすとんゆそう	ピストン輸送
ぱりじょうやく	パリ条約
ぱなまそうもく	Synanthae	Cyclanthales	パナマソウ目
ぱっくりょこう	パック旅行
ぱじゃますがた	パジャマ姿
ぱーれんちゃん	八連荘
ぽりえんかびにる	ポリ塩化ビニル
ぺぷちどけつごう	ペプチド結合
ぷらんくていすう	プランク定数
ぷらすちっくせい	プラスチック製
ぴすとんうんどう	ピストン運動
ぴあにっしっしも	pianississimo
ぱれーとさいてき	パレート最適
ぱたーんにんしき	パターン認識
ぱそこんつうしん	パソコン通信
ぱけっとつうしん	パケット通信
ぱいなっぷるもく	Bromeliales	パイナップル目
ぷろとあくちにうむ	Protactinium	Pa
ぷろぐらむごうせい	プログラム合成
ぽすとこうぞうしゅぎ	ポスト構造主義
ぺんときしろんあこう	Pentoxylidae	ペントキシロン亜綱
ぷろぐらむげんごりろん	プログラム言語理論
ぷろばいだーせきにんほう	プロバイダー責任法
