
よ	讀	与	選	弥	佳	止	夜	訓	好	良	四	舁	飫	與	醉	酔	畭	依	餘	憑	撚	予	拠	丗	詠	譱	世	４	善	避	呼	縒	余	攀	輿	蕷	誉	読	預	喚	歟	因	譽	除	寄	代	豫
ゆ	腴	喩	油	踰	柚	楡	瑜	行	癒	弓	揃	搖	諛	愈	輸	湯	結	兪	蝓	由	揄	茹	覦	逾	揺	遊	徃	諭	征	往	愉	瘉	渝	逝	斎	臾
や	弥	辞	↑	揶	止	殺	夜	罷	哉	遣	耶	→	妬	灼	⇒	燒	矢	已	爺	椰	病	家	↓	屋	野	痩	埜	辭	←	也	冶	彌	焼	谷	演	熄	八	笶
よん	四	４	読ん
よわ	夜半	弱	余話
よろ	宜	蹌踉
よる	夜	依	倚	憑る
より	依	頼	縒	依里	寄	和
よよ	夜々	世々
よも	四方
よめ	夜目	読め	嫁
よむ	読む
よみ	黄泉	嘉	読み
よふ	夜更
よび	豫備	予備	餘	呼び
よば	夜這
よは	餘波	余波
よの	与野
よね	米
よに	夜逃
よな	世馴	夜泣	世慣
よど	澱	淀
よづ	夜釣
よつ	四	四つ
よっ	四
よち	余地	予知	余値	予地	豫知	輿地
よだ	余田	夜立	与田	誉田	依田
よた	yotta	与太	世太
よそ	装	比	餘所	他所	余所	寄
よせ	寄席	寄せ
よす	良過	止す
よじ	四次	捩	四時	余事	予示
よし	佳	喜	好	禧	良	吉	美	克	譱	嘉	葦	禎	膳	由	善	淑	圭	葭	慶	宜	祥	純	芳	義
よさ	善さ	与謝
よご	豫後	予後	汚	余呉
よこ	遣	─	━	横	寄越
よく	杙	抑	峪	弋	翌	沃	緘	翊	翼	浴	良く	慾	欲
よぎ	過	夜着	余技	余儀
よき	予期	豫期
よか	餘暇	善か	余暇	予科	予価
よう	容	羊	用	穃	慵	擁	養	様	窰	癰	泱	拗	佯	殀	癢	蛹	夜討	揚	徭	幺	謡	耀	煬	甬	膺	暘	壅	杳	鷹	搖	昜	遥	傭	溶	厭	漾	腰	孕	夭	邀	陶	酔う	妖	珱	瑤	痒	庸	雍	怏	熔	瓔	遙	曜	楊	窯	蓉	揺	恙	瑶	瀁	曄	慂	姚	陽	葉	廱	要	謠	燿	踊	榕	洋	鎔	踴	窈	幼	樣	八	俑	瘍
よい	良い	酔	余威	酔い	宵
よあ	夜明
ゆん	潤
ゆゑ	故
ゆわ	湯沸
ゆれ	揺れ
ゆる	緩	閖	弛	許	揺	赦	揺る
ゆり	由理	祐里	友梨	百合	有里	由里	由利	閖	由梨	友利	友理	憂里	祐理	岼
ゆら	由良
ゆゆ	由々	忌々	結由	由由
ゆや	油谷	湯屋
ゆめ	結女	梦	夢
ゆみ	有望	有美	祐美	祐未	宙美	弓	優美	由実	由美	友美	裕美
ゆま	由真
ゆふ	由府
ゆび	趾	指
ゆば	湯葉	弓場
ゆに	由仁
ゆな	湯女
ゆで	茹で
ゆづ	讓
ゆだ	湯田	委
ゆた	豊	豐
ゆせ	湯瀬
ゆず	柚	譲	讓	梼	柚子
ゆす	強請	揺	揺す
ゆし	諭旨	油紙	油脂
ゆざ	湯冷
ゆさ	遊佐
ゆげ	遊戯	湯気	弓削
ゆぎ	由木	柚木
ゆき	由岐	由喜	友紀	夕貴	夕紀	由樹	行	幸	志	之	行き	由姫	由希	由貴	有希	湯来	有紀	油機	倖	裄	征	裕紀	恭	由季	由妃	由記	由紀	油木	雪	由綺	由起
ゆが	瑜伽	湯掻	歪	憂花
ゆか	裕香	夕夏	由佳	友華	床	夕香	油化	有香	夕佳	弓佳	由加	友賀	結花	由架	友香	由香
ゆえ	故	優恵	湯江
ゆう	裕	郵	囿	誘	揖	宥	雄	友	結う	柚	悒	猷	猶	佑	融	疣	蕕	蝣	悠	尢	釉	右	熊	侑	由	勇	黝	攸	邑	有	尤	遊	幽	木綿	游	夕	由宇	優	肬	莠	涌	湧	酉	蚰	祐	犹	憂	俑
ゆい	遺	結い	由井	結	由以	由比	由	唯	油井	由衣	湯井	悠衣
やん	楊	梁
やわ	軟	夜話	柔	和
やり	矢理	遣り	鑓	槍
やら	屋良
やゆ	揶揄
やや	漸	稍
やめ	矢目	已め	止め	八女
やむ	已む
やみ	闇
やま	岾	疾	耶麻	疚	山	夜魔
やぼ	野暮
やほ	屋舗	谷保
やべ	矢部
やぶ	薮	敗	破	藪
やひ	野卑
やば	矢場
やは	矢張	軟	柔	和
やの	矢野
やね	屋根
やに	脂
やな	簗	梁
やど	宿
やと	傭	雇	野兎
やつ	八つ	谷津	奴	窶	谷	八
やっ	八
やち	谷地	萢	屋地
やだ	矢田
やた	矢田	八咫	箭田
やそ	八十	耶蘇
やせ	八瀬
やず	谷津
やす	裕	休	安	易	野洲	廉	康	恭	夜須	泰	保	靖
やじ	野次
やし	野史	香具師	椰	椰子
やざ	矢座
やさ	易	優
やけ	自棄	焼け
やぐ	夜具
やく	役	焼く	葯	藥	繹	疫	躍	蜴	鑰	薬	籥	譯	訳	≒	檪	扼	夜久	益	焼	屋久	厄	約	龠
やぎ	柳	山羊	八木
やき	焼き	夜気	燒	焼
やが	屋我	軈
やか	夜火	野花	野火	宅
やお	矢尾	八百	八尾
やえ	八重
やー	Я
よんぶ	四部
よんど	四度
よんく	四駆
よんき	四紀
よんい	四位
よわめ	弱目
よわみ	弱味
よわび	弱火
よわね	弱音
よわた	世渡
よわす	弱過
よわき	弱気
よわい	齢	齡	弱い
よろん	与論	餘論	余論	與論	世論
よろず	万	萬
よろし	宜
よろこ	喜	悦	慶
よろく	余録	余禄
よろい	鎧
よれい	予鈴	余齢
よるべ	寄る辺
よるい	余類
よりわ	選り分
よりめ	寄り目
よりみ	寄り身
よりぬ	選り抜
よりど	選り取
よりつ	寄付
よりそ	寄り添
よりこ	夜梨子	依子	頼子
よりき	寄木	与力	寄り切
よりお	頼男
よりい	寄居
よりあ	寄り合
よよぎ	代々木
よゆう	余裕	餘裕
よやす	世安
よやく	豫約	予約
よもぎ	蒿	艾	蓬
よめな	嫁菜
よめと	嫁取
よめご	嫁御
よめい	嫁入	余命	餘命
よみや	夜宮	宵宮
よみな	読み慣
よみと	読み飛	読み取	読取
よみで	読みで
よみて	読み手
よみち	読み散	夜道
よみだ	読出	読み出
よみせ	夜店
よみす	読み捨
よみじ	黄泉路
よみこ	詠み込	読み込	読込
よみき	読み切	読切	読み聞
よみが	蘓	蘇
よみか	読み書	読み替
よみお	読み終
よみあ	読み上	読み合
よまわ	夜回
よぼう	豫防	予防	與望
よほど	余程
よほう	余方	予報	豫報
よへい	与平	余弊
よぶん	餘分	余分	余聞
よぶこ	呼子
よふん	余憤
よふけ	夜更け	夜更
よふか	夜更
よふう	余風
よびよ	呼び寄
よびや	呼び屋
よびび	予備日
よびひ	予備費
よびね	呼値	呼び値
よびな	呼び名	呼名
よびと	呼び止
よびつ	呼び付
よびだ	呼び出	呼出
よびた	呼び立
よびす	呼び捨
よびさ	呼び覚
よびこ	呼び込	呼子
よびき	予備機
よびか	呼び掛	呼掛	呼び交
よびお	呼び起
よばん	夜番	四番
よばい	夜這い
よはく	余白	餘白
よはい	余輩
よのじ	よノ字
よのう	予納
よねん	餘念	余念	四年	余年	４年
よねづ	米津
よねつ	余熱	予熱
よねだ	米田
よねず	米酢
よねこ	米子
よねお	米雄
よねい	米井
よにん	余人	四人
よにげ	夜逃げ
よなよ	夜な夜
よなべ	夜なべ
よなご	米子
よなき	夜泣き
よなが	夜長
よなか	夜中
よなお	世直
よない	米内
よどみ	澱
よどお	夜通
よどえ	淀江
よとく	余徳	余得
よとぎ	夜伽
よとお	四通
よとう	与党	夜盗
よてき	余滴
よてい	予定	豫定
よづり	夜釣	夜釣り
よづめ	余詰
よつゆ	夜露
よつや	四谷	四ツ谷
よつめ	四つ目
よつみ	四つ身
よつば	四葉
よつぎ	世継	世嗣	世嗣ぎ
よって	∴	依って
よっつ	4つ	四つ
よっか	四日	４日	4日	翼下
よちむ	予知夢
よちず	輿地図
よだん	予断	四段	餘談	豫斷	余談
よだれ	涎
よだつ	与奪	予奪
よだち	夜立ち
よたく	余沢	預託
よたか	夜鷹
よたい	預貸
よぞら	夜空
よそめ	余所目
よそみ	余所見	よそ見
よそほ	裝
よそじ	四十路
よそく	豫測	予測
よそお	装	粧	裝
よそう	予想	豫想
よぜん	余喘
よぜみ	代ゼミ
よせん	予戦	予餞	豫選	予選
よせば	寄場	寄せ場
よせつ	寄せ付	余接
よせく	寄せ来
よせき	余積
よせが	寄せ書	寄書
よせえ	寄せ餌
よせい	余勢	餘勢	余生	餘生
よせあ	寄せ合
よずめ	余詰
よすみ	四隅
よすて	世捨
よすい	余水
よじん	余人	餘人	余燼	余塵
よじつ	余日
よしん	予審	与信	餘震	余震	予診
よしわ	吉和
よしゅ	余種
よしや	善哉	義哉	吉屋	嘉也
よしみ	善美	芳美	好美	義美	吉見	嘉美	由美	由光	義巳	誼	昌美	良美
よしま	吉間
よしほ	美穂
よしば	吉場	吉羽
よしは	吉葉
よしの	吉乃	芳野	美乃	淑乃	吉野
よしな	由無
よしと	義人	圭人	芳人
よしつ	好津
よしだ	吉田	慶田
よしず	葭簀
よしじ	良司	良至	良治
よしこ	佳子	賀子	よし子	良子	ヨシ子	芳子	由子	嘉子	美子	好子	淑子
よしき	好輝	吉城	慶樹	良樹	吉起	由樹	善樹	与式	美樹	善紀	佳樹	芳樹	芳希	吉喜	喜紀	吉敷	嘉樹	義樹	吉輝	芳季
よしか	佳香
よしお	由夫	芳雄	好生	淑生	義夫	昌男	美夫	佳郎	嘉男	好男	善雄	良夫	良男	禧雄	佳男	吉夫	良雄	好央	義男	嘉夫	新生	善男	嘉雄	吉男	好夫	誉志雄	佳雄	善夫	宗生	吉生	好雄	芳男	芳夫	温雄	義雄	吉雄
よしえ	良枝	好江	佳恵	好恵	芳恵	吉江
よしい	吉井	芳井
よしあ	善し悪
よざい	余財	余罪	餘罪
よさん	豫算	予算	予讃
よさむ	夜寒
よさの	与謝野
よさつ	予察
よさく	与作
よごれ	汚れ
よごと	夜毎
よこわ	横割
よこや	横屋	横矢	横谷
よこめ	横目
よこみ	横見
よこば	横這
よこの	横野
よこね	横根
よこど	横取
よこと	横跳
よこで	横手
よこて	横手
よこづ	横付
よこた	横田
よこせ	横瀬
よこず	横好
よこざ	横座
よこく	与国	豫告	予告
よこぎ	横切	横木
よこが	横書
よこお	横尾
よこえ	横絵
よこう	予行	余光	余香	予稿
よこい	横井
よげん	豫言	予言	余弦	預言
よげつ	余月
よけん	与件	豫見	予見
よけつ	預血
よけい	余計	餘計
よぐち	与口
よくん	余薫
よくや	沃野
よくめ	欲目
よくば	欲張
よくど	沃土
よくと	yocto
よくち	沃地
よくし	抑止
よくご	浴後
よくけ	欲気
よくき	翌期
よくか	翼果
よぎり	夜霧
よぎな	余儀無
よぎた	与北
よきん	預金
よかん	予感	余寒	豫感
よかわ	吉川
よかれ	善かれ
よかぜ	夜風
よかく	余核	予覚	余角	与格
よおぎ	八尾木
よえん	余炎
よえつ	与悦
よえい	余映	余栄
ようん	余蘊
ようわ	養和
ようろ	要路
ようよ	漸
ようや	漸
ようむ	妖霧	遥夢	用務	要務	用向
ようま	妖魔	洋間
ようぼ	養母
ようぶ	洋舞	腰部
ようふ	用布	妖婦	養父
ようび	曜日	妖美
ようひ	要否
ように	用に	様に	陽に
ようど	用土	沃度	用度
ようと	用途
ようち	夜討	幼稚	夜討ち	要地	用地
ようだ	用立	様だ
ようた	洋太
ようそ	要素	Iodine	I
ようず	用済	要図
ようす	様子	容子
ようじ	要事	幼時	洋治	用事	幼児	陽治	庸治	耀司	洋二	洋次	曜示	用字	楊枝	陽次	庸次	陽司	陽二	洋司
ようし	羊歯	夭死	要旨	養子	羊脂	洋紙	容姿	用紙	陽子
ようご	用語	擁護	養護	用後
ようこ	楊子	容子	揚子	耀子	よう子	暢子	妖子	瑤子	葉子	庸子	洋子	陽子	妖狐	羊子
ようぐ	要具	庸愚	用具
ようぎ	容儀	容疑	要義
ようき	妖気	容器	妖鬼	陽気
ようが	陽画	洋画	用賀	幼芽
ようか	養家	八鹿	８日	妖花	蛹化	八日
ようい	妖異	用意	容易
よいん	餘韻	余韻	餘音	余音
よいむ	酔夢
よいね	宵寝
よいど	余緯度	酔い止
よいち	余市	四一	世一
よいた	与板
よいし	酔い痴
よいざ	酔い覚	酔醒	酔い醒
よいご	宵越
よいこ	よい子	良い子
よいき	余域
よある	夜歩
よあつ	予圧
よあそ	夜遊
よあけ	夜明け
ゆんも	潤模
ゆんで	左手
ゆゑん	所以
ゆわり	湯割り
ゆわか	湯沸
ゆれも	揺藻
ゆりみ	有里巳
ゆりね	百合根
ゆりこ	祐里子	由利子	祐理子	百合子	ゆり子	由里子
ゆりか	優里香	Liliaceae	ユリ科
ゆりお	揺り起
ゆりえ	由梨絵	百合枝	友里恵
ゆらく	愉楽
ゆらい	由来
ゆよく	湯浴
ゆやま	湯山
ゆもと	湯元	湯本
ゆめよ	夢代
ゆめみ	夢見
ゆめの	夢野
ゆめと	夢人
ゆめじ	夢二	夢路
ゆめこ	夢子
ゆむら	湯村
ゆむき	湯剥き
ゆみや	弓矢
ゆみひ	弓引
ゆみば	弓場
ゆみの	弓野
ゆみた	弓田
ゆみそ	柚味噌
ゆみず	湯水
ゆみこ	祐三子	友美子	裕美子	弓子	優美子	佑三子	祐美子	由美子	有美子
ゆみか	由美香
ゆみえ	弓技	由美恵
ゆまく	油膜
ゆべし	柚餅子
ゆぶね	湯ぶね	湯船	湯舟
ゆふね	湯舟
ゆびわ	指環	指輪
ゆびさ	指差
ゆびき	湯引き
ゆびお	指折
ゆばら	湯原
ゆはら	湯原
ゆのみ	湯飲み	湯呑み
ゆのつ	温泉津
ゆのき	柚木
ゆにわ	弓庭
ゆどの	湯殿
ゆどお	湯通
ゆとう	湯桶
ゆでん	油田
ゆであ	茹で上
ゆてん	油点
ゆてき	油滴
ゆづる	弓弦
ゆづけ	湯漬け	湯漬
ゆづき	弓月	由月
ゆつか	弓束
ゆちゃ	湯茶
ゆだん	油断
ゆだや	猶太
ゆだま	湯玉
ゆだて	湯立
ゆだち	弓立
ゆたに	由谷	湯谷
ゆたか	裕	豊	豐	穰	優	泰	豊か
ゆそつ	輸卒
ゆそう	輸送	油層	油槽	油送	湯槽
ゆせん	湯銭	湯煎
ゆせい	油性	油井
ゆずる	譲	穰	穣	讓
ゆずゆ	柚湯
ゆずこ	柚子
ゆずき	柚木	柚月
ゆすり	強請
ゆすら	桜桃	山桜桃
ゆすぶ	揺振
ゆしま	油島	湯島
ゆざわ	湯沢	湯澤
ゆざめ	湯ざめ	湯冷め
ゆざい	油剤
ゆさん	遊山
ゆさぶ	揺さ振	揺振
ゆさい	油彩
ゆごう	癒合
ゆこく	諭告
ゆげた	弓削田
ゆげい	靫負
ゆけん	油研
ゆけつ	輸血
ゆぐち	湯口
ゆくへ	行方
ゆくは	的
ゆくて	行く手
ゆくえ	行く方	行方
ゆぎん	輸銀
ゆきよ	幸代	雪代
ゆきや	幸也
ゆきめ	雪眼
ゆきみ	雪見
ゆきほ	行穂
ゆきば	行場	行き場
ゆきの	雪野	雪乃
ゆきど	行き止	雪解
ゆきづ	行き詰
ゆきつ	行き付
ゆきち	諭吉
ゆきた	幸田
ゆきす	行き過
ゆきじ	雪路
ゆきこ	由紀子	由季子	有紀子	由起子	友紀子	有希子	夕紀子	由希子	幸子	雪子	有己子	由貴子
ゆきき	行き来
ゆきが	行き掛
ゆきか	幸香	行き交
ゆきお	行夫	悠紀夫	幸男	雪下	悠紀雄	幸雄	行雄	幸應	由希夫	行生	幸生	由起夫	由紀夫	幸夫	由記雄	雪夫
ゆきえ	雪絵	幸恵	由紀江	幸枝	幸栄	幸江	由起絵	由喜枝	好恵
ゆきあ	行き当	行き合	雪明
ゆがわ	湯川
ゆがま	湯釜
ゆかん	湯灌
ゆかわ	湯川	湯河
ゆかり	由香利	由加利	由加里	由佳里	由香里	紫	由架梨	友佳梨	縁	由佳利
ゆかの	由佳乃
ゆかた	浴衣
ゆかこ	友華子	優香子	由香子	有香子	裕香子
ゆかい	愉快
ゆおん	油温	湯温
ゆえん	結縁	油煙	所以	由縁
ゆえに	∴	故に
ゆえつ	諛悦	愉悦	踰越
ゆえき	輸液
ゆえい	輸贏
ゆうわ	友輪	融和	優和	宥和	雄和
ゆうり	悠里	悠理	遊里	有理	有利	友里	遊離
ゆうよ	猶予	有余
ゆうや	夕焼	雄也	裕弥	裕哉	裕也
ゆうむ	有無
ゆうみ	裕美
ゆうま	遊馬
ゆうほ	遊歩
ゆうべ	夕べ	昨夜	夕
ゆうぶ	勇武
ゆうふ	有夫
ゆうび	優美
ゆうひ	雄飛	夕日	夕陽
ゆうば	夕晴	夕映
ゆうに	優に
ゆうな	夕菜
ゆうど	裕度	尤度
ゆうと	雄図	勇人	雄途
ゆうち	誘致
ゆうだ	遊惰
ゆうた	祐太	由宇太
ゆうじ	勇二	祐地	裕司	雄士	祐司	右二	佑二	祐之	雄次	雄司	裕志	裕二	祐治	祐史	有事	裕治	祐次	裕史	雄志	雄爾	祐二	友二	勇次	雄二	勇治	裕慈
ゆうし	遊資	勇史	有司	猶子	有志	雄視	有史	勇姿	雄志	右史	勇士	融資	雄姿	有刺	遊子	憂思
ゆうこ	友子	裕有子	木綿子	悠子	侑子	由子	夕子	有子	ゆう子	祐子	裕子	由布子	優子
ゆうげ	夕餉
ゆうぐ	遊具	夕暮
ゆうく	憂苦
ゆうぎ	友誼	遊技	遊戯
ゆうき	雄希	優樹	結城	裕樹	勇気	幽鬼	夕貴	有規	祐己	夕樹	有機	雄基	雄規	有希	勇喜	有紀	祐希	憂木	悠紀	有期	優起	優希	裕木	友樹	又木	夕希	誘起	有基
ゆうが	勇牙	優雅
ゆうか	有価
ゆうい	有意	優位	雄偉	有為
ゆいま	維摩
ゆいび	唯美
ゆいつ	唯一
ゆいが	唯我
ゆいか	結花
ゆあみ	湯浴み
ゆあつ	油圧
ゆあさ	湯淺	湯浅
ゆあか	湯垢
やんべ	山家
やわら	谷和原	柔
やわた	八幡
やろう	野郎
やるき	遣る気	やる気	ヤル気
やりば	遣り場	やり場
やりぬ	やり抜	遣り抜
やりと	遣り取	遣り遂	やり遂
やりて	やり手
やりつ	遣り付
やりだ	やり出	遣り出
やりた	鎗田
やりす	遣り過	やり過
やりこ	遣り込	やり込
やりき	遣り切
やりお	やり終	遣り終
やりあ	やり合	遣り合
やらい	夜来	矢来
やよい	弥生
やもり	夜森	守宮
やもめ	寡	鰥	鰥夫
やもと	矢本
やもお	鰥
やみよ	闇夜
やみや	闇屋
やみね	闇値
やみつ	病み付
やみじ	闇路
やまわ	山分
やまや	山矢	山屋	山家
やまも	山盛
やまめ	山女
やまむ	山向
やまみ	山見
やまま	山回
やまべ	山辺	山部
やまび	山日
やまば	山場	ヤマ場
やまは	山葉
やまの	山野
やまね	山根
やまな	山名
やまと	大和	山門
やまて	山手
やまづ	山積
やまだ	山田
やまぞ	山沿
やませ	山瀬	山背
やまじ	山路	山地
やまし	山師
やまさ	山佐
やまご	山越
やまけ	山気
やまき	山木	八巻	八槇	八槙
やまが	山鹿	山香	山賀	山家
やまお	山尾
やまえ	山江
やまい	病	山井
やぼう	野望
やほり	矢堀
やほこ	八穂子
やほう	野砲
やぶん	夜分
やぶれ	殕
やぶみ	矢文
やぶた	藪田
やぶさ	吝
やぶき	矢吹
やぶか	薮蚊
やひろ	八尋
やひこ	弥彦
やばん	野蛮
やばね	矢羽
やばせ	矢橋
やはん	夜半
やはり	矢張り
やはば	矢巾
やはた	八幡
やはく	夜泊
やはぎ	矢作	八萩	矢矧
やぬし	家主
やにわ	矢場
やにさ	脂下
やなる	矢鳴
やなり	家鳴り
やなみ	八並	家並	家並み
やなば	簗塲
やなつ	柳津
やなだ	梁田
やなせ	梁瀬	柳瀬
やなぎ	柳
やなか	谷中
やなお	柳尾
やない	屋内	矢内	箭内	柳井
やどや	宿屋
やどな	宿無
やどか	宿借
やとみ	弥富
やとう	野党	野盗	夜盗
やとい	雇
やづつ	矢筒
やつら	奴等
やつで	八手
やつだ	谷津田
やつざ	八つ裂
やつぎ	矢継
やつか	八束
やつお	八尾
やっつ	八つ	遣っ付
やっこ	奴
やっき	躍起
やっか	薬科	薬価	薬禍
やちん	屋賃	家賃
やちよ	八千代
やちほ	八千穂
やちだ	谷内田	谷地田
やちた	谷地田
やだま	矢玉
やだね	矢種
やたら	矢鱈
やたま	矢玉
やたべ	矢田部	谷田部
やたて	矢立
やたい	屋台
やぞう	弥蔵
やそじ	八十路
やそう	夜走	野草
やぜん	夜前
やせん	野選	野戦	夜戦
やせつ	夜雪
やせち	痩せ地
やせい	野性	野生
やずぎ	八杉
やすり	鑢
やすら	安ら	安良
やすよ	康代	安代	康世	靖代
やすや	恭也
やすめ	安目	安め
やすみ	休	休み	保美
やすは	泰葉
やすの	安野
やすね	安値
やすな	保名
やすと	保人	靖人
やすで	安手
やすて	野ステ
やすだ	安田	保田
やすす	安過
やすじ	康嗣	康司	康次	康二
やすし	尉	泰司	保司	康史	寧	安	靖史	泰士	廉史	康	也寸志	泰	靖志	保	靖
やすさ	安さ
やすこ	康子	妥子	泰子	安子	靖子	恭子
やすけ	弥助
やすぎ	安来	八杉
やすき	靖己	泰樹	康己	安樹
やすお	保夫	泰男	泰夫	靖雄	靖夫	保生	寿男	泰雄	康雄	八洲男	恭朗	弥寿夫	康生	康夫	安男	保雄	泰生	裕雄	安雄	康男	保男
やすえ	保江	康恵	安江	安恵
やすう	安売
やすい	保井	安井	靖
やすあ	安上
やじん	野人
やじり	鏃	矢尻
やじま	矢島	矢嶋	谷島	八島
やしん	野心
やしろ	安城	屋代	八代	矢代	社
やしゅ	野手	野趣
やしゃ	夜叉
やしま	屋島	矢島
やしな	養	豢
やしち	弥七
やしき	廛	屋敷	矢輔	邸	屋輔	壥
やしお	八潮	八入
やざわ	谷沢	矢沢	矢澤
やざき	矢崎
やさと	八郷
やさし	易し	優し
やさく	矢作
やさき	矢先
やさか	八坂	弥栄	八尺
やさい	野菜
やごと	八事
やごし	矢越
やごえ	矢声
やごう	野合	屋号
やこう	矢向	八高	夜光	夜香	夜行
やげん	薬研
やけん	野犬
やけの	焼野
やけど	火傷
やけし	焼け死
やけこ	焼け焦
やけお	焼け落
やけい	夜景	野鶏	夜警
やぐら	矢倉	櫓
やぐち	谷口	矢口
やくわ	役割
やくり	薬理
やくよ	厄除
やくゆ	薬湯
やくも	八雲
やくめ	役目
やくみ	薬味
やくぼ	矢久保
やくび	厄日
やくば	役場
やくの	夜久野
やくて	約手
やくづ	役付
やくだ	役立
やくた	役立
やくじ	薬事	薬餌
やくし	訳詩	訳詞	薬師
やくご	訳語
やくぎ	役儀
やぎり	矢切
やぎた	八木田
やぎざ	山羊座
やきん	夜勤	冶金	野禽
やきめ	焼目	焼き目
やきふ	焼麩
やきば	焼刃	焼場	焼き場	焼き刃
やきつ	焼き尽	焼き付
やきす	焼き過	焼き捨
やきき	焼き切
やきえ	焼絵	焼き絵
やきあ	焼き上
やがわ	矢川
やがも	矢鴨
やがみ	矢上	八神
やがて	軅	軈て	軈
やがけ	矢掛
やがく	夜学
やがい	屋外	野外
やかん	薬鑵	野干	夜間	薬罐	薬缶
やから	族	輩
やかま	喧
やかた	屋形	舘	館
やかず	矢数	家数
やかげ	矢掛
やかい	夜会
やおん	野音
やおら	徐ら
やおや	八百屋
やおつ	八百津
やおし	八尾市
やおぎ	八尾木
やおき	八起
やおい	矢追
やえん	野猿	夜宴
やえば	八重歯
やえす	八重州	八重洲
やえこ	彌生子	八重子
やえい	野営	夜営
やうや	漸
やうち	矢内	家内
やいん	夜陰
やいば	刃
やいと	灸
やいづ	焼津
やいだ	矢井田
やいた	矢板
やーど	碼
よんりん	四輪
よんもく	四目
よんめん	四面
よんめい	４名
よんまい	四枚
よんほん	四本
よんぶん	四分
よんひき	四匹
よんぱく	四白
よんねん	四年
よんなん	四男
よんとう	四島
よんだい	四台	四大
よんたく	四択
よんせい	四声
よんじょ	四女
よんしゃ	4者
よんごう	四合
よんこう	4項
よんけん	４研	四研
よんかい	四階
よわりめ	弱り目
よわりは	弱り果
よわりき	弱り切
よわよわ	弱々
よわむし	弱虫
よわみそ	弱味噌
よわふく	弱含
よわたり	世渡り
よわごし	弱腰
よろずや	万屋
よろしく	宜しく
よろこん	喜ん
よろこび	喜び	悦び	慶び	憙
よろいど	鎧戸
よるよる	夜々
よるよう	夜用
よるひる	夜昼
よるがた	夜型
よるおそ	夜遅
よりょく	餘力	余力
よりみち	寄り道
よりまし	尸童	憑坐
よりのぶ	頼信
よりとも	頼朝
よりつき	寄付き
よりちか	頼近
よりしろ	依代	憑代
よりしま	寄島
よりごの	選り好
よりきり	寄り切り
よりいと	縒り糸
よりあわ	縒り合
よりあつ	寄り集
よりあき	頼晶	頼芸	頼明
よりあい	寄り合い	寄合
よやとう	与野党
よやくひ	予約費
よやくじ	予約時
よやくご	予約語
よやくか	予約課
よもやま	四方山
よもぎだ	蓬田
よもぎた	蓬田
よもぎう	蓬生
よめとり	嫁取り
よめじょ	嫁女
よめさん	嫁さん
よめいり	嫁入	嫁入り
よみょう	余命
よみもの	読み物	読物
よみほん	読本
よみふだ	読み札
よみふけ	読み耽
よみはじ	読み始
よみにく	読み難
よみなが	読み流
よみなお	読み直
よみとり	読み取り
よみづら	読み辛
よみつづ	読み続
よみちが	読み違
よみだし	読み出し
よみたに	読谷
よみすす	読み進
よみすご	読み過
よみこみ	読込	読み込み
よみくら	読み比	読み較
よみきり	読切	読切り
よみがな	読み仮名
よみがえ	甦	蘓	蘇
よみかた	読み方
よみかき	読み書き
よみかえ	読み返
よみおと	読み落
よみうり	読売	讀賣
よみあげ	読上げ	読み上げ
よまわり	夜回り
よまつり	夜祭	夜祭り
よほうし	予報士
よほうく	予報区
よふかし	夜更し	夜更かし
よびりん	呼び鈴
よびょう	余病
よびもの	呼び物
よびもど	呼び戻
よびみず	呼び水
よびてき	予備的
よびつづ	呼び続
よびだし	呼び出し	呼出	呼出し
よびせん	予備選
よびすて	呼びすて	呼捨て	呼び捨て
よびしん	予備審
よびしゃ	予備車
よびごえ	呼び声
よびこみ	呼び込み
よびこう	予備校
よびけん	予備検
よびけい	呼び径
よびぐん	予備軍	予備群
よびがわ	呼び側
よびかわ	呼び交
よびかた	呼び方
よびかけ	呼掛	呼掛け
よびかえ	呼び返
よびえき	予備役
よびあつ	呼び集
よばわり	呼ばわり
よばなし	夜咄
よのなか	世の中
よのてん	与野店
よのつね	世の常
よのすけ	世之介
よのうづ	米水津
よねんめ	四年目
よねやま	米山
よねもり	米森
よねもと	米本
よねむら	米村
よねみつ	米光
よねはる	米春
よねはら	米原
よねなが	米長
よねじま	米嶋
よねしま	米嶋
よねざわ	米澤	米沢
よねざき	米崎
よねぐち	米口
よねくら	米倉
よねきち	米吉
よねかわ	米川
よにんめ	四人目
よにゅう	預入
よにげや	夜逃げ屋
よなよな	夜な夜な
よなばる	与那原
よなぐに	与那国
よなくに	与那国
よなおし	世直し
よどせん	予土線
よどぎみ	淀君
よどがわ	淀川
よどおし	夜通し
よていび	予定日
よていち	予定地
よつわり	四つ割り
よつやま	四つ山
よつばし	四つ橋
よつどき	四つ時
よつつじ	四辻
よつくら	四倉
よつぎり	四切	四つ切
よつかど	四つ角
よついけ	四ツ池
よつあし	四足	四つ足
よっぱら	酔っ払
よっかめ	四日目
よちれん	予知連
よちょう	予兆	余丁
よちかん	予知観
よたろう	与太郎	四太郎
よたもの	与太者
よそよそ	余所余所
よそゆき	余所行き
よそもの	よそ者	他所者	余所者
よそごと	余所事
よそくち	予測値
よそくき	予測器
よそおい	装	装い
よそうや	予想屋	予想家
よそうち	予想値
よそうず	予想図
よそいき	余所行き
よせもと	寄元
よせもじ	寄席文字
よせなべ	寄せ鍋
よせざん	寄せ算
よせがき	寄せ書き	寄書き
よせあつ	寄せ集
よじろう	与次郎
よじょう	余情	餘剩	餘情	余剰
よじのぼ	攀じ上
よじげん	四次元
よしわら	吉原
よしろう	義郎	喜朗	芳郎	善郎	嘉朗	与四郎
よしょく	余色
よしゆき	由行	嘉雪	好幸	義行	義之	芳行	良幸	吉行	嘉之	良之	誉志幸	嘉志	善之	佳之	義幸	佳行	善幸
よしゅう	余臭	予習	豫習
よしやま	吉山
よしやす	好康	嘉康
よしもり	吉森
よしもと	吉本	芳本
よしむら	吉村	義村	芳村
よしむね	義統	吉宗
よしみつ	芳充	喜光	義光	善光	嘉光	吉光
よしみち	由道
よしみず	吉水
よしまつ	吉松	由松
よしまさ	義正	義雅	喜昌	良昌	好正
よしぶえ	葦笛
よしふみ	仁史	善文	良文	祥史	義文	佳文	好文
よしひろ	佳寛	良宏	良広	嘉伯	義浩	嘉宏	至寛	吉廣	慶大	吉弘	美博	良博	好広	喜弘	由泰	良祐	喜博	義裕	佳泰	吉広	義博	佳浩	義宏	善弘	吉宏	良浩	嘉浩	義広	善博	嘉弘	義弘
よしひと	芳仁	芳人	由人	圭仁	善一
よしひで	善英	良英	慶英
よしひさ	善久	良久	慶久	由久	嘉久	純央	義久	芳久
よしひこ	喜彦	義彦	吉彦	慶彦	嘉彦	芳彦	義比古	善彦	良彦
よしはる	喜晴	佳春	義春	善治	吉春	義治	芳晴	義晴	喜治
よしはら	吉原
よしはま	吉浜
よしのり	義昇	良紀	義範	嘉典	美徳	良規	佳典	芳則	吉則	良則	善範	嘉哲	吉徳	彬伯	由規	好則	美則	善則	義典	佳則	良憲	芳範	吉典	芳規	善典	由典	良法	佳紀	良教	良典	義則	賀悟	芳徳	善徳	嘉則	義徳
よしのや	吉野屋	吉野家
よしのぶ	嘉伸	栄伸	慶喜	義信	芳信	良伸
よしなり	義成	善成	義也	能成	良成	悌也	芳成	吉成	祐生
よしなが	良永	吉永
よしなか	義仲	吉仲
よしなお	義直	喜直
よしどめ	吉留
よしとも	義恭	義智	佳友	義朋	良知
よしとみ	吉富	善富
よしとし	吉年	義敏
よしとお	義遠
よしてる	喜照	芳輝
よしづか	吉塚
よしつね	義経
よしつぐ	善次	佳次	善嗣
よしだや	吉田屋
よしたに	吉谷
よしたけ	吉竹	義丈	義竹	尚武	美武	吉武
よしたか	孝高	嘉隆	佳孝	吉高	芳孝	良隆	善隆	義孝	義隆	禎孝	義高	善孝
よしぞう	芳三
よしずみ	吉住
よしすけ	義介
よしじま	吉島
よしざわ	吉澤	吉沢	義澤	芳沢
よしざき	吉崎
よしさと	義聡
よしさだ	悦貞	義貞
よしこし	吉越
よしくに	吉国	美邦	喜国
よしきり	葦切	葦雀
よしきよ	義清
よしがみ	吉上
よしがき	芳垣
よしかわ	好川	吉川
よしかつ	隆克	良勝	好克	義勝
よしかず	佳和	慶一	佳一	能収	良和	美一	義一	英一	義和	善和	喜一	芳一	由和	好一	善一
よしおみ	善臣	佳臣
よしおか	吉岡
よしうら	吉浦
よしうみ	吉海
よしいち	義一
よしいけ	吉池
よしあし	善悪	善し悪し
よしあき	嘉明	克明	義昭	嘉昭	良昭	吉昭	義明	吉晃	由明	吉明	喜明	良秋	善章	良晃	芳明	義章	義亮	義晃	純明	義朗	嘉晃	良明	嘉章	美明	宜明	善昭
よざくら	夜桜
よざかり	世盛り
よさんい	予算委
よごころ	世心
よこわり	横割り
よこわけ	横分
よこよこ	横横
よこやり	横やり	横槍
よこやま	横山
よこもり	横森
よこもの	横物
よこもじ	横文字
よこむき	横向	横向き
よこみつ	横光
よこみち	横道
よこみぞ	横溝
よこまる	横丸
よこまつ	横松
よこまち	横町
よこぼり	横堀
よこぼう	横棒
よこほん	横本
よこほり	横堀
よこぶり	横降り
よこぶえ	横笛
よこひら	横平
よこばら	横腹
よこばし	横走
よこばい	横ばい	横這い
よこはま	横浜	横濱
よこはば	横巾	横幅
よこはね	横羽
よこのり	横乗り
よこなら	横並
よこなみ	横波	横並
よこなが	横長	横流
よこどり	横取り
よこどい	横樋
よことび	横跳び	横飛び
よことじ	横綴じ
よこづみ	横積
よこづな	横綱
よこづけ	横付け
よこつら	横面
よこつか	横塚
よこっと	横っ飛
よこだお	横倒
よこたに	横谷
よこせん	─	横線
よこずき	横好き
よこすべ	横滑
よこすじ	横筋
よこすか	横須賀
よこじま	横縞
よこじく	横軸
よこしま	横しま	奸	邪ま	邪	辟	横島
よこしば	横芝
よこざわ	横沢
よこざま	横方	横樣
よこさと	横里
よこごし	横越
よこげり	横蹴り
よこけい	横罫
よこぐみ	横組
よこくら	横倉
よこがわ	横河	横川
よこがみ	横紙
よこがた	横型
よこがく	横額
よこがき	横書き	横書
よこがお	横顔
よこかわ	横河	横川
よこかべ	横壁
よこかぜ	横風
よこおき	横置き	横置
よこうち	横内
よこいと	緯糸	横糸
よこいち	横位置
よこいた	横板
よこあめ	横雨
よこあな	横穴
よこあい	横合い	横合
よげんは	余弦波
よくれつ	翼列
よくよく	翼々	翌々
よくよう	浴用	抑揚
よくめん	翼面
よくぼう	欲望	慾望
よくぶか	欲深
よくふか	欲深
よくばん	翌晩
よくばり	欲張り	欲張
よくねん	欲念	翌年
よくどう	欲動
よくとし	翌年
よくとく	欲得
よくたん	翼端
よくそう	浴槽
よくせい	抑制
よくじつ	翌日
よくしん	欲心	慾心
よくしつ	浴室
よくさん	翼賛
よくげつ	翌月
よくけい	翼形
よくがた	翼型
よくかい	欲界
よくうつ	抑鬱
よくあつ	抑圧
よくあさ	翌朝
よぎしゃ	夜汽車
よきょう	余響	余興	餘興
よがたり	夜語り
よかれん	予科練
ようろん	要論
ようろく	要録
ようろう	養老
ようれつ	庸劣
ようれき	陽暦
ようれい	用例	妖霊	妖麗
ようりつ	擁立
ようりく	揚陸
ようらん	洋蘭	揺籃	要覧
ようらく	瓔珞
ようよう	揚々	妖々	要用	様々	幼葉
ようゆう	溶融	熔融
ようやく	要約
ようもん	要文
ようもの	洋物
ようもく	要目
ようもう	養毛	羊毛
ようめん	容面
ようめい	用命	溶明	幼名	養命
ようむき	用向き
ようまん	養鰻
ようまつ	洋松
ようまく	羊膜
ようぼく	幼木	用木
ようぼう	要望	容貌	杳茫
ようほん	洋本
ようほう	養蜂	用法	陽報
ようべん	用便
ようへん	曜変	窯変
ようへき	擁壁
ようへい	傭兵	葉柄	洋平	用兵
ようぶん	養分	幼文
ようぶつ	陽物
ようふぼ	養父母
ようふく	洋服
ようふう	洋風
ようひん	用品	洋品
ようひつ	用筆
ようひし	羊皮紙
ようばん	洋盤
ようばい	溶媒
ようはん	洋販
ようはつ	洋髪
ようはい	遥拝
ようねん	幼年
ようにん	傭人	用人	容認
ようにく	葉肉
ようなし	洋ナシ	用無し	洋梨	洋なし
ようどう	幼童	揺動	陽動
ようとん	養豚
ようとじ	洋綴じ
ようとう	羊頭	洋燈
ようてん	要点	陽転
ようてい	羊蹄	幼帝	揚程	要諦
ようつう	腰痛
ようつい	腰椎
ようだん	用談	要談
ようだい	煬帝	容態	容体
ようたつ	用達
ようたい	容態	様態	容体
ようぞん	溶存
ようぞう	洋三	容三	陽三
ようそわ	要素和
ようそう	洋装	様相
ようせん	用箋	傭船	用船
ようせつ	殀折	夭折	溶接	熔接	要説
ようせき	容積
ようせい	妖星	夭逝	葉性	幼生	妖精	養成	要請	陽性
ようずみ	用済み
ようすみ	様子見
ようすけ	庸介	洋助	洋輔	洋介	洋祐	葉介	陽介
ようすい	用水	陽水	揚水	羊水
ようじん	要心	洋人	用心	要人
ようじょ	養女	葉序	妖女	幼女
ようじご	幼児語
ようじき	幼児期
ようじか	幼児化
ようしん	葉身	養親
ようしょ	洋書	要所
ようしゅ	洋酒	楊朱	洋種
ようしゃ	用捨	容赦	幼者
ようしば	洋芝
ようしつ	溶質	洋室
ようしし	養嗣子
ようしき	様式	要式	洋式
ようざん	腰斬	要斬
ようざら	洋皿
ようざい	用材	溶剤
ようさん	養蚕	洋算	葉酸
ようさい	洋裁	洋才	要塞
ようごは	用語派	擁護派
ようこん	幼根
ようこう	要綱	陽光	要港	洋行	用高	要項	妖光
ようげん	揚言	用言	妖言
ようげき	要撃	邀撃
ようけん	要件	洋犬	用件
ようけつ	溶血	要訣
ようけい	幼形	養鶏
ようくん	幼君
ようぎん	洋銀
ようぎょ	幼魚	養魚
ようきん	溶菌	用金	要緊	洋斤	洋琴	洋禽
ようきひ	楊貴妃
ようがん	容顔	熔岩	溶岩
ようがし	洋菓子
ようがさ	洋傘
ようがく	洋学	洋楽
ようがい	要害
ようかん	陽関	羊羮	腰間	洋館	羊羹
ようかた	養方
ようかい	溶解	熔解	容喙	妖怪	鎔解
ようおん	拗音
ようえん	葉縁	妖艶	揺炎	陽炎
ようえき	用役	葉腋	溶液	用益
ようえい	揺曳
よういん	要員	要因
よういち	暢一	要一	洋一	陽一
よういく	養育
ようあん	溶暗
よいんし	余因子
よいやみ	宵闇
よいやま	宵山
よいみや	宵宮
よいまち	宵待
よいどれ	酔いどれ
よいどめ	酔い止め
よいづき	宵月
よいつぶ	酔い潰
よいっぱ	宵っ張
よいごし	宵越し
よあるき	夜歩き
よあらし	夜嵐
よあそび	夜遊び
よあかし	夜明し
ゆわかし	湯沸し
ゆれうご	揺れ動
ゆるゆる	揺る揺る	緩々	緩緩
ゆるやか	緩やか
ゆるしあ	許し合
ゆるがせ	忽せ
ゆりょう	湯量
ゆりもく	ユリ目	Liliales
ゆりこう	Liliopsida	ユリ綱
ゆりかご	揺り籠
ゆりおこ	揺り起
ゆりうご	揺り動
ゆりいす	揺り椅子
ゆりあげ	閖上
ゆゆしき	由々しき
ゆめどの	夢殿
ゆめぞの	夢園
ゆめさき	夢前
ゆめおち	夢オチ
ゆめいろ	夢色
ゆみへん	弓偏
ゆみへい	弓兵
ゆみはり	弓張
ゆみなが	弓長
ゆみなか	弓仲
ゆみとり	弓取
ゆみづる	弓弦
ゆみけず	弓削
ゆみがた	弓形
ゆみおか	弓岡
ゆふばえ	夕暎え
ゆふいん	由布院	湯布院
ゆびもじ	指文字
ゆびばん	指板
ゆびぬき	指貫き	指貫
ゆびづか	指使
ゆびさき	指先
ゆびきり	指切り
ゆびおり	指折り
ゆびあな	指孔
ゆのまえ	湯前
ゆのはま	湯野浜
ゆのたに	湯之谷
ゆのかわ	湯野川	湯ノ川
ゆにゅう	輸入
ゆどおし	湯通し
ゆどうふ	湯豆腐
ゆとうよ	湯桶読
ゆでだこ	茹で蛸
ゆでじる	茹で汁
ゆづかれ	湯疲れ
ゆづかみ	湯津上
ゆちゃく	癒着
ゆだなか	湯田中
ゆたんぽ	湯湯婆
ゆたゆた	揺た揺た
ゆたかさ	豊かさ	豊さ
ゆそうろ	輸送路
ゆそうひ	輸送費
ゆそうじ	輸送時
ゆそうき	輸送機
ゆずりは	譲葉
ゆずりう	譲り受
ゆずりあ	譲り合
ゆずみそ	柚味噌
ゆずがま	柚釜
ゆすりと	強請り取
ゆすはら	梼原
ゆしょく	愉色
ゆしょう	油症
ゆしゅつ	輸出
ゆざまし	湯冷まし
ゆさぼう	遊佐坊
ゆさてき	遊佐的
ゆさいが	油彩画
ゆけむり	湯煙
ゆくはし	行橋
ゆくとし	行く年
ゆくすえ	行く末
ゆくさき	行先	行く先
ゆくかた	行く方
ゆぎょう	遊行
ゆきわた	行き渡
ゆきよし	幸喜	幸義
ゆきやま	雪山
ゆきもと	雪本
ゆきむら	幸村
ゆきむし	雪虫
ゆきみつ	幸光
ゆきみち	雪道	雪路	幸道
ゆきまつ	行松	雪祭
ゆきまさ	幸真	幸政	幸正
ゆきふみ	幸史
ゆきひろ	幸拾	行弘	行宏	幸宏	幸展	幸博	幸広	幸弘
ゆきひら	行平
ゆきひと	幸仁
ゆきひで	幸秀
ゆきひこ	由記彦	由紀彦	幸彦	行彦	恭彦
ゆきばれ	雪晴れ
ゆきばな	雪花
ゆきはる	幸春
ゆきはだ	雪肌
ゆきのり	行則	幸範	幸典	幸記	幸紀	行徳	幸則	幸徳
ゆきのぶ	之宣	行信
ゆきぬけ	行き抜け
ゆきなり	志勢	幸成	行成
ゆきなや	行き悩
ゆきどけ	雪解け
ゆきとり	雪取
ゆきとみ	幸富
ゆきとど	行き届
ゆきとし	礼暁	幸俊	幸敏
ゆきつけ	行き付け
ゆきちが	行き違
ゆきだま	雪玉
ゆきだお	行き倒
ゆきたに	雪谷
ゆきたけ	雪竹	裄丈
ゆきたか	幸貴
ゆきぞら	雪空
ゆきぞう	行三
ゆきずり	行き摩り
ゆきすぎ	行過ぎ
ゆきしつ	雪質
ゆきさき	行き先	行先
ゆきぐも	雪雲
ゆきぐみ	雪組
ゆきぐに	雪国
ゆきくら	雪倉
ゆきがた	行き方
ゆきがけ	行き掛け
ゆきかよ	行き通
ゆきかべ	雪壁
ゆきかた	行き方
ゆきかぜ	雪風
ゆきかき	雪掻き
ゆきかえ	行き帰
ゆきおれ	雪折れ
ゆきいり	雪入
ゆきあた	行き当
ゆきあか	雪垢
ゆきあい	行合
ゆがわら	湯河原
ゆがしま	湯ケ島	湯が島	湯ヶ島
ゆかよう	床用
ゆかめん	床面
ゆかほん	床本
ゆかばり	床張り
ゆかした	床下
ゆかざい	床材
ゆかげん	湯加減
ゆかぐみ	床組
ゆかうえ	床上
ゆかいた	床板
ゆえよし	故由
ゆうわく	誘惑
ゆうれつ	優劣
ゆうれき	遊歴
ゆうれい	幽霊	優麗
ゆうりん	友隣
ゆうりょ	憂慮
ゆうりし	有利子
ゆうらん	遊覧
ゆうらく	有楽	遊楽
ゆうよく	有翼	遊弋
ゆうよう	有用	悠揚	融溶
ゆうゆう	悠々	融々	悠悠
ゆうやみ	夕闇
ゆうやけ	夕焼	夕焼け
ゆうやく	釉薬	勇躍
ゆうもん	憂悶	幽門
ゆうもや	夕靄
ゆうもう	有毛	勇猛
ゆうめん	宥免
ゆうめし	夕飯
ゆうめい	幽冥	勇名	有名	幽明
ゆうみん	遊民
ゆうまぐ	夕間暮
ゆうぼく	遊牧
ゆうぼう	有望
ゆうほう	友朋	雄峰	友邦
ゆうべん	雄弁
ゆうべつ	湧別
ゆうへん	雄篇	雄編
ゆうへい	幽閉	雄平	裕平
ゆうふん	憂憤
ゆうふつ	勇払
ゆうふく	裕福
ゆうびん	郵便	〒
ゆうひつ	祐筆
ゆうばれ	夕晴れ
ゆうばり	夕張
ゆうばく	誘爆
ゆうばえ	夕暎え	夕映え
ゆうはん	有半	夕飯	雄藩
ゆうはつ	誘発
ゆうはい	有配
ゆうのう	有能
ゆうなみ	夕波
ゆうなぎ	夕凪
ゆうどく	有毒
ゆうどう	遊動	有働	誘導
ゆうとく	祐徳	有徳
ゆうとう	雄踏	友党	遊蕩	優等
ゆうでん	誘電
ゆうてん	融点
ゆうてい	夕定
ゆうづる	夕鶴
ゆうづき	有月	夕月
ゆうづう	融通
ゆうちょ	郵貯
ゆうだん	勇断
ゆうだち	夕立	夕立ち
ゆうだい	雄大
ゆうたい	幽体	勇退	優待	融体	郵袋
ゆうぞう	裕三	祐三	勇蔵	勇三	雄三
ゆうそく	有職
ゆうそう	郵送	遊走	雄壮	勇壮
ゆうぜん	友禅	悠然
ゆうぜい	郵税	有税	游説	遊説
ゆうせん	湧泉	有線	優先	勇戦	郵船	涌泉
ゆうせつ	融雪
ゆうせき	有責
ゆうせい	遊星	優勢	郵政	有性	優生	幽静	有声	雄性	優性	有生
ゆうずう	融通
ゆうずい	雄蕊
ゆうすず	夕涼
ゆうすけ	雄介	裕介	祐介	祐輔	勇輔	有祐	幽助	勇介	雄輔	佳祐
ゆうすう	有数
ゆうすい	湧水	有水	幽邃
ゆうじん	有人	友人	遊人
ゆうじょ	宥恕	遊女	佑助
ゆうじゃ	雄者
ゆうしん	有信	有心	雄心	憂心
ゆうしゅ	郵趣
ゆうしゃ	優者	勇者
ゆうしつ	幽室
ゆうしき	有識
ゆうしお	夕潮
ゆうざん	雄山
ゆうざい	有罪
ゆうさん	有産
ゆうさく	裕作	雄策	優作	雄作	勇作	祐策
ゆうさい	雄才	幽斎
ゆうごう	融合
ゆうこん	雄渾	幽魂
ゆうこく	憂国	幽谷	夕刻
ゆうこう	有孔	友好	裕弘	有功	遊興	幽光	有効	有向	遊行
ゆうげん	幽幻	幽玄	祐源	有言	有限
ゆうげき	遊撃
ゆうげい	遊芸
ゆうけん	有権	勇健	郵券
ゆうけい	有形	雄勁	夕景
ゆうぐん	友軍	遊軍
ゆうぐれ	夕暮れ	夕暮
ゆうぐも	夕雲
ゆうぐう	優遇
ゆうぎり	夕霧
ゆうぎょ	游魚	勇魚
ゆうぎき	遊戯機	遊技機
ゆうきん	遊金
ゆうきょ	幽居
ゆうきや	有機屋
ゆうきづ	勇気付
ゆうきち	祐吉	勇吉	有吉
ゆうがた	夕方
ゆうがく	遊楽	遊学
ゆうがお	夕顔
ゆうがい	有害	有蓋
ゆうかん	有閑	夕刊	遊観	勇悍	有感	幽閑	幽間	勇敢	憂患
ゆうかぜ	夕風
ゆうかげ	夕影	夕陰
ゆうかく	遊廓	遊客
ゆうかい	有界	幽界	融解	誘拐
ゆうおう	勇徃
ゆうえん	悠遠	結縁	遊園	優婉	幽艶	有鉛	優艶	幽遠
ゆうえつ	優越	勇悦
ゆうえき	有益
ゆうえい	游泳	遊泳
ゆううつ	憂鬱
ゆういん	誘因	誘引	有印
ゆういみ	有意味
ゆういち	勇一	雄一	有一	裕一	祐一	友一	優一	夕市
ゆういさ	有意差
ゆういぎ	有意義
ゆうあん	幽暗
ゆうあく	優渥
ゆうあい	友愛
ゆいぶつ	唯物
ゆいのう	結納
ゆいしん	唯心
ゆいしょ	由緒
ゆいしき	唯識
ゆいごん	遺言
ゆいえき	由比駅
ゆいいつ	唯一	惟一
ゆあたり	湯中り
やんばる	山原
やわらか	柔
やわはだ	柔肌
やりよう	やり様
やりもち	槍持
やりみず	遣り水	鑓水
やりのこ	遣り残	やり残
やりなげ	槍投げ
やりなお	遣り直	やり直
やりとり	遣り取り	やり取り
やりつく	遣り尽
やりだま	槍玉	やり玉
やりそん	やり損	遣り損
やりそこ	やり損	遣り損
やりすご	遣り過	やり過
やりしき	やり式
やりこな	遣り熟
やりくち	遣り口	やり口	遣口
やりがい	遣り甲斐	やり甲斐
やりかた	やり方
やりかえ	遣り返	やり返
やりいか	槍烏賊
やよいご	弥生語
やよいき	弥生期
やゆてき	揶揄的
ややおも	稍重
やむちゃ	飲茶
やみもり	闇森
やみなべ	闇鍋
やみつき	病み付き
やみごめ	闇米
やみくも	闇雲
やみきん	闇金
やみがた	止み難
やみうち	闇討	闇討ち
やみいち	闇市
やみあが	病み上
やまんば	山姥
やまわけ	山分け
やまわき	山脇
やまよう	山用
やまゆり	山百合
やまゆき	山行	山雪
やまやま	山々
やまやき	山焼き
やまもり	山森	山守	山盛り
やまもも	山桃
やまもと	山本	山元
やまむろ	山室
やまむら	山村
やまみち	山道
やままん	山万
やままゆ	山繭	天蚕
やままつ	山松
やまぼこ	山鉾
やまほど	山程
やまへん	山偏
やまぶち	山淵
やまぶし	山伏
やまぶき	山吹
やまふだ	山札
やまふじ	山藤
やまびら	山開
やまびと	山人
やまびこ	山彦	谺
やまひだ	山襞
やまばと	山鳩
やまはら	山原
やまはだ	山肌
やまはた	山畑
やまはい	山廃
やまのぼ	山登
やまのて	山の手	山手
やまねこ	山猫
やまにし	山西
やまなり	山形	山鳴り
やまなみ	山並	山並み
やまなし	山梨
やまなか	山中
やまどり	山鳥
やまどめ	山止め
やまとみ	山富
やまとに	大和煮
やまとじ	大和路
やまとし	大和市
やまとご	大和語
やまとえ	大和絵	倭絵
やまでん	山電
やまでら	山寺
やまてら	山寺
やまづら	山面
やまづみ	山積み
やまつり	矢祭
やまつか	山塚
やまっけ	山っ気
やまちく	山蓄
やまだし	山出し
やまだい	山大
やまたに	山谷
やまたけ	山武
やまたか	山高
やまたい	耶馬台
やまぞえ	山添
やまぞい	山沿い
やまそと	山外
やまそだ	山育
やまぜん	山善
やまずみ	山積
やまずい	山瑞
やますそ	山裾
やますげ	山菅
やましろ	山城
やましな	山科
やました	山下
やましぎ	山鷸
やまざる	山猿
やまざと	山里
やまざき	山崎	山咲
やまさわ	山沢
やまさち	山幸
やまさき	山崎
やまさか	山坂
やまごや	山小屋
やまごし	山越し
やまごえ	山越え
やまこし	山越	山腰	山古志
やまこう	山交
やまけい	山渓
やまぐも	山雲
やまぐま	山隈
やまぐに	山国
やまぐち	山口
やまくら	山倉
やまくに	山国
やまくず	山崩
やまくさ	山草
やまぎん	山吟
やまぎわ	山際	山極
やまぎし	山岸
やまきた	山北
やまがわ	山側	山川
やまがり	山狩	山狩り
やまがら	山雀
やまがみ	山上	山神
やまがつ	山賤
やまがち	山勝ち
やまがた	山型	山県	山形	山縣	山方
やまがさ	山笠
やまかん	山勘
やまかわ	山川
やまかみ	山上
やまかぜ	山風
やまかじ	山火事
やまかさ	山笠
やまかげ	山影	山陰
やまかけ	山掛け
やまかい	山峡
やまおり	山折り
やまおく	山奥
やまおき	山沖
やまおか	山岡
やまうら	山浦
やまうば	山姥
やまうち	山内
やまいも	山芋
やまいぬ	山犬	豺	犲
やまいち	山一證券
やまいし	山石
やまある	山歩
やまあし	山足
やまあい	山間	山合
やぼよう	野暮用
やぼてん	野暮天
やほうず	野放図
やべせん	矢部線
やぶれめ	破れ目
やぶもと	薮本	藪本
やぶへび	薮蛇
やぶはら	薮原
やぶにら	藪睨
やぶそば	薮蕎麦
やぶすま	矢衾
やぶさわ	薮沢
やぶさめ	薮鮫	流鏑馬	薮雨
やぶさか	吝か
やぶきた	藪北
やぶがみ	薮上
やぶうち	薮内
やぶいり	藪入り
やばとん	矢場とん
やばけい	耶馬渓
やはたの	八幡野
やはたし	八幡市
やのはら	矢箆原
やのけん	矢野研
やのぐち	矢野口
やのくら	矢野倉
やねゆき	屋根雪
やねづけ	屋根付
やねした	屋根下
やねざい	屋根材
やねごし	屋根越し
やねがた	屋根型
やねうら	屋根裏
やねうま	屋根馬
やねいた	屋根板
やなはら	柵原
やなとり	梁取
やなだに	柳谷
やなざき	柳崎
やなぎや	柳家	柳谷
やなぎば	柳葉	柳刃
やなぎだ	柳田
やなぎた	柳田
やながわ	柳川	梁川
やないづ	柳津
やどわり	宿割り
やどろく	宿六
やどりぎ	寄生木	宿り木
やどりき	宿木
やどひき	宿引き
やどぬし	宿主
やどなし	宿無し
やどちん	宿賃
やどだい	宿代
やどせん	宿銭
やどさが	宿探
やどがえ	宿替え
やどかり	寄居虫	宿借り	寄居蟲
やどいり	宿入り
やといい	雇い入
やつわり	八つ割り
やつもり	八ッ森
やつはし	八橋	八ツ橋	八つ橋
やつだま	八玉
やつしろ	八代
やつざき	八つ裂き
やつくち	八口
やつがれ	僕
やつかほ	八束穂
やつあた	八つ当
やっぱり	矢つ張り
やっとこ	鋏
やっての	遣って退
やっこう	薬効
やっかん	約款
やっかい	訳解	厄介
やちよし	八千代市
やちょう	夜鳥	野帳	野鳥
やちゅう	夜中
やちまた	八街	八衢
やたろう	弥太郎
やたやま	矢田山
やたでら	矢田寺
やたけび	矢叫び
やたがい	矢田貝
やそすけ	八十助
やそしま	八十島
やそかわ	八十川
やそかい	耶蘇会
やせほそ	痩せ細
やせぎす	痩せぎす
やせがた	痩せ形	やせ型
やせうま	痩せ馬
やせうで	痩せ腕
やせいみ	野生味	野性味
やせいじ	野性児	野生児
やせいか	野性化
やすろう	恭郎	康朗
やすらか	安らか
やすよし	靖佳	安吉	康義	康良	康善
やすゆき	靖幸	泰幸	泰之	保之	育志	康幸	恭之	康之	康行	靖之
やすやど	安宿
やすやす	易々
やすもの	安物
やすもと	安本
やすむら	安村
やすみつ	康満	康光
やすみち	易道
やすみあ	休み明
やすまつ	安松
やすまさ	康雅	泰正	康正
やすぶみ	康文
やすふみ	康文	康史	泰史
やすひろ	靖宏	泰広	康広	康弘	康宏	保浩	康博	靖弘	康裕	保広	泰宏	恭弘	恭裕	泰寛	保博	安浩	康浩	泰弘	靖浩	安弘	靖太
やすひと	保人	康仁
やすひで	保秀
やすひさ	恭久	靖久
やすひこ	泰彦	安彦	靖彦	康彦
やすはる	康晴	泰治	泰晴	康治
やすはら	安原	保原
やすのり	保則	靖則	靖教	安則	泰典	保徳	保憲	泰憲	康則	保法	泰則	保典	安紀	康徳
やすのぶ	恭伸	泰信	保信
やすのう	安納
やすなり	康也	康成
やすなが	康永	保永	安永
やすなお	康尚
やすとも	康友
やすとめ	安留
やすとみ	安富
やすとし	康敏	泰稔	康俊
やすてつ	康哲
やすづか	安塚
やすたみ	康民
やすたに	保谷
やすたけ	康剛	安武
やすたか	泰隆	泰孝	泰臣	康隆	泰宇
やすしば	安柴
やすざけ	安酒
やすざか	安坂
やすさと	安里
やすさだ	保貞
やすくに	安国	靖国
やすきよ	安挙
やすかわ	安川
やすかた	安方
やすかず	康一	保和	保一
やすかが	安加賀
やすおか	泰阜	安岡
やすうり	安売	安売り
やすうら	安浦
やすいけ	安池
やすあき	泰昭	保昭	恭章	康明
やすあが	安上
やじるし	→	⇔	↑	↓	⇒	←	矢印
やじゅう	野獣
やじまや	谷島屋
やじきた	弥次喜多
やじうま	野次馬	弥次馬
やしんか	野心家
やしわご	玄孫
やしょく	夜色	夜食
やしゅう	夜襲
やしゃご	玄孫
やしもく	Principes	ヤシ目	Aracales	Palmales
やしのみ	椰子の実
やさがた	優形
やこぜん	野狐禅
やけやま	焼け山	焼山
やけのこ	焼け残
やけだけ	焼岳
やけただ	焼け爛
やけざけ	やけ酒	自棄酒	焼け酒	ヤケ酒
やけこげ	焼け焦げ
やけくそ	自棄糞
やけいし	焼け石
やけあと	焼け跡	焼跡
やぐるま	矢車
やぐらな	櫓投
やくわり	役割
やくろん	約論
やくろう	薬籠
やくよけ	厄除	厄除け
やくよう	薬用
やくもの	役物	約物
やくめい	役名
やくむき	役向き
やくまん	役満
やくまわ	役回
やくまる	薬丸
やくほん	訳本
やくほう	薬方	薬包
やくぶん	訳文	約分
やくぶつ	薬物
やくひん	薬品
やくばら	厄払
やくはら	厄祓
やくにん	役人
やくにた	役に立
やくなん	厄難
やくなし	訳無
やくどし	厄年
やくどく	訳読	役得	薬毒
やくどう	躍動
やくとく	役得
やくとう	薬湯
やくてん	薬店
やくてい	約定
やくづき	役付き	役付
やくだつ	役立つ
やくだく	約諾
やくだい	薬代
やくたい	益体
やくそく	約束
やくそう	薬草	躍層
やくぜん	薬膳
やくせき	薬石
やくすぎ	屋久杉
やくすう	約数
やくじん	厄神	疫神
やくじょ	躍如
やくしん	躍進	薬疹
やくしょ	役所	訳書
やくしゅ	薬酒	薬種
やくしゃ	訳者	役者
やくしま	屋久島
やくしじ	薬師寺
やくざい	薬剤
やくさつ	薬殺	扼殺
やくさい	訳載	薬菜	厄災
やくげん	約言
やくがら	役柄
やくがく	薬学
やくがえ	役替え
やくがい	薬害
やくかい	訳解
やくおん	約音
やくえき	薬液
やくいん	約因	役印	役員	薬院
やくあり	訳有
やぎょう	夜行	や行	夜業	ヤ行
やぎゅう	野牛	柳生
やぎやま	八木山
やぎはし	八木橋
やぎぬま	八木沼
やぎさわ	八木沢
やぎがわ	山羊革
やきょく	夜曲
やきゅう	野球
やきもの	焼物	焼き物
やきめし	焼飯	焼き飯
やきみそ	焼味噌	焼き味噌
やきまし	焼増し	焼き増し	焼増
やきぶた	焼豚
やきはら	焼き払
やきはた	焼き畑	焼畑
やきのり	焼き海苔
やきにく	焼肉	焼き肉
やきなま	焼鈍	焼き鈍
やきなす	焼き茄子
やきなお	焼き直	焼直
やきとり	焼鳥	焼き鳥
やきつけ	焼付け	焼付
やきつく	焼き尽
やきたて	焼き立て
やきそば	焼きそば
やきすぎ	焼き杉	焼杉
やきしお	焼き塩	焼塩
やきごて	焼き鏝	焼鏝
やきころ	焼き殺
やきぐり	燒栗
やきぐし	焼き串	焼串
やきがし	焼き菓子
やきかた	焼き方
やきうち	焼討ち	焼き討ち
やきいん	焼印	焼き印
やきいろ	焼き色
やきいれ	焼入れ
やきいも	焼き芋	焼芋
やきあみ	焼網	焼き網
やがわら	谷川原
やかんぶ	夜間部
やかもち	家持
やおもて	矢面
やおはん	八百半
やおはら	八百原
やおとめ	八乙女
やおくめ	八百粂
やおいた	矢尾板
やえやま	八重山
やえがし	八重樫
やえがき	八重垣
やいごめ	焼米
よんばんめ	四番目	4番目
よんどかく	四度核
よんちゃく	四着
よんじゅう	四重	四十
よんしょく	四色
よんしょう	四章	四商
よんしまい	四姉妹
よんさいば	四歳馬
よんぎょう	四行
よんきゅう	四球	四級
よんがっか	四学科
よんかいめ	四回目
よわふくみ	弱含み
よろいざわ	鎧沢
よるよなか	夜夜中
よるちゃく	夜着
よるごはん	夜御飯
よりどころ	據	拠り所	拠所	より所	拠
よりたおし	寄り倒し
よりいかん	寄居間
よやくらん	予約欄
よやくよう	予約要
よやくめい	予約名
よやくぶん	予約分
よやくせき	予約席
よやくせい	予約制	予約性
よやくしゃ	予約者
よやくけん	予約券
よやくきん	予約金
よもすがら	終夜
よもぎもち	蓬餅
よめえらび	嫁選び
よみのくに	黄泉の国	黄泉国
よみとりき	読み取り機
よみごたえ	読み応え
よみこみじ	読み込み時
よみあわせ	読み合わせ	読合せ
よみあやま	読み誤
よまいごと	世迷い言
よぼうほう	予防法
よぼうそち	予防措置
よぼうせん	予防線
よぼうさく	予防策
よぼうきん	予防菌
よびよせん	予備予選
よびもどし	呼び戻し
よびでんち	予備電池
よびちしき	予備知識
よびじあい	予備試合
よびしんさ	予備審査
よびしあい	予備試合
よびこせん	呼子線
よびこうか	予備校化
よびぎろん	予備議論
よびかいぎ	予備会議
よばたらき	夜働き
よのならい	世の習い
よねんせい	四年生
よねばやし	米林
よねだけん	米田研
よねざわし	米沢市
よなぐすく	与那城
よないやま	米内山
よどやばし	淀屋橋
よどみばし	澱橋
よどばやし	淀屋橋
よどしゃこ	淀車庫
よとうむし	夜盗虫
よていひん	予定品
よていどお	予定通
よていせん	予定線
よていすう	予定数
よていしゃ	予定者
よていこう	予定稿
よていがい	予定外
よていあん	予定案
よつんばい	四つん這い
よつやなぎ	四柳
よつやえき	四谷駅
よつめとじ	四つ目綴じ
よつめがき	四つ目垣
よつずもう	四つ相撲
よっぱらい	酔っ払い	酔っぱらい
よっきゅう	欲求
よっかいち	四日市
よちょきん	預貯金
よだれかけ	涎掛け
よだいすう	余代数
よたばなし	与太話
よたくきん	預託金
よたいりつ	預貸率
よそくりつ	予測率
よそくほう	予測法
よそくてき	予測的
よそくせい	予測性
よそくごさ	予測誤差
よそくがた	予測型
よそくがい	予測外
よそうほう	予想法
よそうどお	予想通
よそうしゃ	予想者
よそうごさ	予想誤差
よそうきじ	予想記事
よそうがい	予想外
よそうかい	予想会
よせんごと	予選毎
よせんけん	予選券
よせんかい	予餞会
よせんおち	予選落
よせあつめ	寄せ集め
よすてびと	世捨て人
よじみゃく	四次脈
よしのやま	吉野山
よしのだに	吉野谷
よしのせん	吉野線
よしのがわ	吉野川
よしとせん	吉都線
よしだみわ	吉田美和
よしたろう	芳太郎	由太郎
よしきゅう	与死球
よさんわく	予算枠
よさんはん	予算班
よさんてき	予算的
よさんせん	予讃線
よさんがく	予算額
よさんがい	予算外
よさんあん	予算案
よさぶろう	与三郎
よさぶそん	与謝蕪村
よごれやく	汚役	汚れ役
よごれもの	汚れ物
よこれんぼ	横恋慕
よこぶとり	横太り
よこばしり	横走り
よこはまや	横濱屋	横浜屋
よこはまし	横浜市
よこならび	横並び
よこなぐり	横殴り
よこながれ	横流れ
よこながし	横流し
よこてやま	横手山
よこてさん	横手山
よこっぱら	横っ腹
よこっとび	横っ飛び
よこっつら	横っ面
よこちょう	横丁	横町
よこだおし	横倒し
よこたきち	横田基地
よこすべり	横滑り
よこすかし	横須賀市
よここうず	横構図
よこぐるま	横車
よこくよう	予告用
よこくへん	予告篇	予告編
よこくどお	予告通
よこくとう	予告灯
よこがめん	横画面
よこおけん	横尾研
よこいどう	横移動
よげんしょ	予言書
よげんしゃ	予言者	預言者
よくりゅう	翼龍	抑留	翼竜
よくのかわ	欲の皮
よくねんど	翌年度
よくちょう	翌朝	翼長
よくそくじ	抑速時
よくじょう	翼状	浴場	抑情	欲情	慾情
よくしゅん	翌春
よくしゅう	翌秋	翌週
よくうかん	余空間
よきんしゃ	預金者
よきんがく	預金額
よがりごえ	善がり声
よかじかん	余暇時間
ようりょく	揚力	妖力
ようりょう	養料	要領	用量	容量
ようりゅう	楊柳
ようりゃく	要略
ようらんき	揺籃期
ようむさき	用務先
ようむいん	用務員
ようみょう	幼名
ようみゃく	葉脈
ようふよう	要不要
ようふくや	洋服屋
ようびめい	曜日名
ようびべつ	曜日別
ようびごと	曜日毎
ようひんや	用品屋
ようのすけ	洋之介	陽之助
ようねんし	幼年誌
ようねんき	幼年期
ようとべつ	用途別
ようとして	杳として
ようでんし	陽電子
ようでんき	陽電気
ようちょう	窈窕	膺懲	羊腸
ようちゅう	幼虫	鎔鑄
ようちえん	幼稚園
ようたろう	洋太郎
ようそすう	要素数
ようそぐん	要素群
ようそかん	要素間
ようせつぶ	溶接部
ようするに	要するに
ようすこう	揚子江
ようすいろ	用水路
ようじろう	陽治郎	洋次郎
ようじよう	幼児用
ようじょう	養生	洋上
ようじゅつ	妖術
ようじゅう	妖獣
ようじゃく	幼弱	幼若
ようじほう	用字法
ようじせい	幼児性
ようしんし	養親子
ようしろう	陽志郎
ようしょや	洋書屋
ようしょく	要職	洋食	養殖	容色
ようしょう	幼少	要衝	葉鞘
ようしゅん	陽春
ようしゅう	揚州
ようしはば	用紙幅
ようしつき	用紙付き
ようしきび	様式美
ようしえん	要支援
ようざっし	洋雑誌
ようさいか	要塞化
ようごろん	擁護論
ようごほう	用語法
ようごへん	用語編
ようこうろ	鎔鉱爐	溶鉱炉	鎔鉱炉
ようげんか	溶原化
ようぎょう	窯業
ようぎしゃ	容疑者
ようきょく	謡曲	陽極
ようきょう	佯狂
ようきゅう	楊弓	洋弓	要求
ようがっき	洋楽器
ようがけい	洋画系
ようかかん	八日間	8日間
ようかいち	八日市
ようかいご	要介護
ようえきち	要役地
よういせい	容易性
よういくひ	養育費
よういおん	陽イオン
よいまつり	宵祭
よいのくち	宵の口
よいづきよ	宵月夜
よいっぱり	宵っ張り
よいざまし	酔い覚まし
よいごこち	酔心地
よあけまえ	夜明け前
よーろっぱ	欧羅巴	歐羅巴
よーどらん	ヨード卵
ゆわかしき	湯沸かし器	湯沸器	湯沸かし機
ゆるすまじ	許すまじ
ゆりかもめ	百合鴎
ゆりかえし	揺り返し
ゆらんかん	輸卵管
ゆらのすけ	由良之助
ゆめまくら	夢枕
ゆめのしま	夢の島
ゆめごこち	夢心地
ゆめきぶん	夢気分
ゆめきこう	夢紀行
ゆめがたり	夢語り
ゆめかかく	夢価格
ゆめうつつ	夢現
ゆめあわせ	夢合せ
ゆみがはま	弓ヶ浜
ゆびづかい	指遣い	指使い
ゆびさっく	指サック
ゆにゅうば	輸入馬
ゆにゅうじ	輸入時
ゆとうよみ	湯桶読み
ゆでたまご	茹で卵
ゆそうよう	輸送用
ゆそうたい	輸送隊
ゆそうせん	油槽船	輸送船
ゆそうしゃ	輸送車
ゆそうきど	輸送輝度
ゆそうかん	輸送管	輸送艦
ゆせいかん	輸精管
ゆずりわた	譲り渡
ゆずりうけ	譲り受け
ゆすらうめ	山桜桃
ゆぎしょう	湯起請
ゆきわかれ	行別れ
ゆきもよう	雪模様
ゆきもどり	行き戻り
ゆきみざけ	雪見酒
ゆきみぐさ	雪見草
ゆきまつり	雪祭	雪祭り
ゆきぶそく	雪不足
ゆきびさし	雪庇
ゆきのすけ	雪ノ助
ゆきどころ	行き所
ゆきだるま	雪だるま	雪ダルマ	雪達磨
ゆきだおれ	行き倒れ
ゆきすずめ	雪雀
ゆきじるし	雪印
ゆきげしき	雪景色
ゆきけむり	雪煙
ゆきがこい	雪囲い
ゆきおんな	雪女
ゆきおろし	雪下ろし
ゆきおとこ	雪男
ゆきおこし	雪起し
ゆきうさぎ	雪兎
ゆきあそび	雪遊び
ゆきあかり	雪明り
ゆがしゅう	瑜伽宗
ゆかいはん	愉快犯
ゆおんけい	油温計
ゆうわさく	融和策
ゆうりょく	有力
ゆうりょう	遊猟	優良	有料
ゆうりゃく	雄略
ゆうりふり	有利不利
ゆうりてき	有理的
ゆうりすう	有理数
ゆうりかく	遊離核
ゆうめいば	有名馬
ゆうめいす	有名過
ゆうまぐれ	夕間暮れ
ゆうぼうし	有望視
ゆうほどう	遊歩道
ゆうべんか	雄弁家
ゆうびんや	郵便屋
ゆうびんう	郵便受
ゆうひょう	遊標	融氷	有標
ゆうひかく	有斐閣
ゆうぱっく	ゆうパック
ゆうはもん	幽波紋
ゆうねつき	有熱期
ゆうどうき	誘導機
ゆうてんじ	祐天寺
ゆうちょう	悠長
ゆうちゃく	融着
ゆうたろう	裕太郎
ゆうそうひ	郵送費
ゆうそうか	郵送可
ゆうせんど	優先度
ゆうすずみ	夕涼み
ゆうすいち	遊水池
ゆうじろう	雄二郎	裕次郎	悠二郎
ゆうじょう	友情
ゆうじゅう	優柔
ゆうじゃく	幽寂
ゆうしょく	憂色	夕食	有色	有職
ゆうしょう	有償	優勝	勇将	湧昇	優賞
ゆうしゅん	優駿
ゆうしゅつ	湧出
ゆうしゅう	有終	幽囚	優秀	幽愁	憂愁
ゆうししゃ	有志者
ゆうしさき	融資先
ゆうしかく	有資格
ゆうごはん	夕御飯	夕ご飯
ゆうごうろ	融合炉
ゆうこうぶ	有効部
ゆうこうび	有効日
ゆうこうど	友好度
ゆうこうだ	有効打
ゆうこうぎ	有向木
ゆうこうか	有効化
ゆうげんち	有限値
ゆうげんこ	有限個
ゆうけむり	夕煙
ゆうぐんき	友軍機
ゆうぎほう	遊技法
ゆうぎだい	遊技台
ゆうぎしゃ	遊戯者
ゆうきょう	遊侠	遊興
ゆうきゅう	悠久	有給	有休	遊休
ゆうきゃく	遊脚
ゆうきぶつ	有機物
ゆうきてき	有機的	有基的
ゆうきたい	有機体
ゆうきしつ	有機質
ゆうきざい	有機材
ゆうきさん	有機酸
ゆうきおん	有気音
ゆうがとう	誘蛾灯
ゆうかんし	夕刊紙
ゆうかぶつ	有価物
ゆうかだん	憂歌団
ゆうえんち	遊園地
ゆういてん	優位点
ゆういせい	有意性	優位性
ゆういしゃ	優位者
ゆうあかり	夕明り
ゆいのうや	結納屋
ゆいがろん	唯我論
ゆいがはま	由比ヶ浜
ゆいいつち	唯一知
ゆあつしき	油圧式
ゆあつけい	油圧系	油圧計
ゆーろやす	ユーロ安
ゆーろだか	ユーロ高
ゆーざかい	ユーザ会
やんごとな	止事無
やんぐりつ	ヤング率
やわたはま	八幡浜
やるせない	遣る瀬ない
やりてばば	遣り手婆
やりっぱな	遣りっ放
やりそこな	やり損	遣り損
やりきへい	槍騎兵
やりがだけ	槍岳
やりがたけ	槍ヶ岳	鑓ヶ岳
やよいもん	弥生門
やよいどき	弥生土器
やよいじん	弥生人
やむをえず	止むを得ず
やむごとな	止事無
やみとりひ	闇取り引
やみそうば	闇相場
やまやしき	山屋敷
やまもとや	山本屋
やままつり	山祭り	山祭
やまほうし	山法師
やまびらき	山開き
やまのぼり	山登り
やまのさち	山の幸
やまのくち	山之口
やまのかみ	山之上	山の神
やまのうち	山之内	山内	山ノ内
やまのうえ	山上
やまのいも	山の芋	薯蕷
やまねこざ	山猫座
やまなしし	山梨市
やまなかこ	山中湖
やまととじ	大和綴じ
やまとぐら	大和鞍
やまときち	大和基地
やまとがわ	大和川
やまとえき	大和駅
やまといも	大和芋
やまてせん	山手線
やまだせん	山田線
やまだがわ	山田川
やまそだち	山育ち
やましろや	山代屋
やましなく	山科区
やまざくら	山桜
やまごもり	山籠り
やまごぼう	山牛蒡
やまぐちし	山口市
やまくずれ	山崩れ
やまがたし	山形市
やまおとこ	山男
やまあるき	山歩き
やまあらし	山嵐
やまあそび	山遊び
やぶのなか	藪の中
やぶにらみ	藪睨み
やぶだたみ	藪畳
やひこせん	弥彦線
やひこざわ	矢彦沢
やばんじん	野蛮人
やはんまえ	夜半前
やはたやま	八幡山
やはたにし	八幡西
やのあきこ	矢野顕子
やねじょう	屋根上
やなぎもと	柳本
やなぎもく	ヤナギ目	Salicales
やなぎまち	柳町
やなぎぼり	柳堀
やなぎばし	柳橋
やなぎはら	柳原
やなぎだる	柳樽
やなぎたに	柳谷
やなぎしま	柳島
やなぎさわ	柳沢	柳澤
やなぎごし	柳腰
やなぎいろ	柳色
やないはら	矢内原
やどちょう	宿帳
やどさがり	宿下がり
やとうむし	夜盗虫
やといぬし	雇い主	雇主
やといにん	雇人
やつぎばや	矢継ぎ早
やつがだけ	八ヶ岳	八岳
やつがたけ	八ヶ岳
やつがしら	八頭
やつあたり	八つ当り	八つ当たり
やっきょく	薬局
やっきょう	薬莢	薬夾
やちよばし	八千代橋
やちよだい	八千代台
やちよかん	八千代間
やちまたし	八街市
やたがらす	八咫烏	八咫鴉
やたいむら	屋台村
やたいぼね	屋台骨
やそよろず	八十万
やそきょう	耶蘇教
やそうえん	野草園
やせんぐん	野戦軍
やせっぽち	痩せっぽち
やせぐすり	痩せ薬
やせがまん	痩せ我慢
やせおとろ	痩せ衰
やせいてき	野性的
やせいしゅ	野性種
やすものが	安物買
やすみあけ	休み明け
やすぶしん	安普請
やすっぽい	安っぽい
やすじろう	安二郎
やすうけあ	安請合	安請け合
やじろべえ	弥次郎兵衛
やじろべい	弥次郎兵衛
やじゅうは	野獸派	野獣派
やしんてき	野心的
やしんさく	野心作
やしゅじん	野手陣
やしきまち	屋敷町
やしきあと	屋敷跡
やさすがた	優姿
やさおとこ	優男
やさいるい	野菜類
やさいぞえ	野菜添え
やさいしつ	野菜室
やこうびん	夜行便
やこうばす	夜行バス
やこうせい	夜行性	夜光性
やげんぼり	薬研堀
やけぶとり	焼け太り
やけびたい	焼額
やけひばし	焼け火箸
やけのはら	焼け野原	焼野原
やけだされ	焼け出され
やぐらもん	櫓門
やぐらなげ	櫓投げ
やくりょう	薬料
やくりきし	役力士
やくりがく	薬理学
やくみざら	薬味皿
やくみけい	薬味系
やくまわり	役回り
やくほうし	薬包紙
やくぶそく	役不足
やくびょう	疫病
やくばらい	厄払い
やくはんね	約半値
やくはらい	厄払い
やくなんこ	約何個
やくどころ	役所
やくちゅう	訳註	薬中	訳注
やくずもう	役相撲
やくじょう	約定
やくじゅつ	訳述
やくじほう	薬事法
やくしょく	役職
やくしゅつ	訳出
やくしゃえ	役者絵
やくしまる	薬師丸
やくしどう	薬師堂
やくしだけ	薬師岳
やくざもの	やくざ者
やくざいし	薬剤師
やくごめん	役御免
やくぎょう	訳業
やくがくぶ	薬学部
やくおとし	厄落し	厄落とし
やきんがく	冶金学
やきりんご	焼き林檎	焼林檎	焼きリンゴ
やきゅうぶ	野球部
やきやぶり	焼き破り
やきびたい	焼額
やきにくや	焼肉屋
やきなまし	焼き鈍し	焼鈍し
やきなおし	焼直し
やきどうふ	焼豆腐	焼き豆腐
やきとりや	焼鳥屋	焼き鳥屋
やきざかな	焼魚	焼き魚
やきうどん	焼き饂飩
やがっこう	夜学校
やがいよう	野外用
やがいげき	野外劇
やかたまち	屋形町
やかたぶね	屋形船	屋形舟
やかいまき	夜会巻き
やかいふく	夜会服
やおよろず	八百万
やおちょう	八百長
やえむぐら	八重葎
やえすぐち	八重洲口
やえすがわ	八重洲側
やえざくら	八重桜
やえいずみ	八重泉
よんろくばん	四六版
よんりんどう	四輪道
よんりんしゃ	四輪車
よんぶんかつ	四分割
よんびょうし	四拍子
よんとうこく	四等国
よんせんねん	四千年
よんしょうめ	四勝目
よんしゅるい	四種類	4種類
よんごうびん	四合瓶
よんげんすう	四元数
よんけたほう	四桁法
よんきょうか	四教科
よんかんおう	四冠王
よんかいせい	四回生
よわよわしい	弱々しい
よろこびいさ	喜び勇
よろいむしゃ	鎧武者
よろいせんし	鎧戦士
よりあいがき	寄合書
よゆうばりき	余裕馬力
よゆうじかん	余裕時間
よやくろくが	予約録画
よやくようし	予約用紙
よやくひょう	予約表
よやくてはい	予約手配
よやくちゅう	予約中
よやくそうち	予約装置
よやくじゅん	予約順
よやくきろく	予約記録
よやくきゃく	予約客
よやくきのう	予約機能
よやくきげん	予約期限
よやくがかり	予約係
よやくかのう	予約可能
よやくかいし	予約開始
よもつしこめ	黄泉津醜女
よめごりょう	嫁御寮
よみうりせん	読売戦
よみうりけい	読売系
よみうりがわ	読売側
よぼうどうさ	予防動作
よぼういがく	予防医学
よほうじかん	予報時間
よびよびしん	予備予備審
よびめんきょ	予備免許
よびへんせい	予備編成
よびちょうさ	予備調査
よびだしがわ	呼出側
よびせっけい	予備設計
よびすいせん	予備水洗
よびじっけん	予備実験
よびしんぱん	予備審判
よびこうせい	予備校生
よびこうさつ	予備考察
よびかいせき	予備解析
よばんちょう	四番丁
よねやまけん	米山研
よねしろがわ	米代川
よねさかせん	米坂線
よねいちまる	米一丸
よにんしゅう	四人衆
よなぐにじま	与那国島
よなくにとう	与那国島
よなかじゅう	夜中中
よていりりつ	予定利率
よていひょう	予定表
よていじこく	予定時刻
よていじかん	予定時間
よていかかく	予定価格
よつかいどう	四街道
よちょうまち	余丁町
よそくふのう	予測不能
よそくどおり	予測通り
よそくきそく	予測規則
よそうりゆう	予想理由
よそうひょう	予想表
よそうどおり	予想通り
よそうかのう	予想可能
よせんりーぐ	予選リーグ
よせんとっぱ	予選突破
よせんつうか	予選通過
よせんちゅう	予選中
よせんけっか	予選結果
よせえんげい	寄席演芸
よじょうはん	四畳半
よじょうせい	余剰性
よじょうしゃ	余剰車
よじょうぎみ	余剰気味
よじじゅくご	四字熟語
よしゅうよう	予習用
よしなしごと	由無し事
よしづかえき	吉塚駅
よしつねぞう	義経像
よしつねごう	義経号
よしだちょう	吉田町
よしだしげる	吉田茂
よしきりざめ	葦切鮫
よさんぶそく	予算不足
よさんそしき	予算組織
よさんじょう	予算上
よさのあきこ	与謝野晶子
よごふりょう	予後不良
よこよこどう	横横道
よこもじすう	横文字数
よこみねでら	横峰寺
よこほうこう	横方向
よこぶんれつ	横分裂
よこひょうじ	横表示
よこばいかく	横倍角
よこはまばん	横浜版
よこはまはく	横浜博
よこはまてん	横浜店
よこはまちく	横浜地区
よこはません	横浜線	横浜戦
よこはまじん	横浜人
よこはましぶ	横浜支部
よこはまごむ	横浜ゴム
よこはまこう	横浜高	横浜港
よこはまがわ	横浜側
よこはまがた	横浜方
よこはまかん	横浜間
よこはまえき	横浜駅
よこながばん	横長版
よこてくかん	横手区間
よこすかせん	横須賀線
よこすかきち	横須賀基地
よこすかえき	横須賀駅
よこざひょう	横座標
よここくだい	横国大
よこくとうき	予告登記
よこかわえき	横川駅
よこかいてん	横回転
よこうしゅう	予稿集
よこいっせん	横一線
よこいちれつ	横一列
よげんふのう	予言不能
よくよくじつ	翌々日
よくめんせき	翼面積
よくせいてき	抑制的
よくせいせい	抑制性
よくせいざい	抑制剤
よくせいさく	抑制策
よくせいがた	抑制型
よくじつぶん	翌日分
よくしりょく	抑止力
よくしゅるい	翼手類
よくしつよう	浴室用
よくしこうか	抑止効果
よくげつぶん	翌月分
よくげつごう	翌月号
よくあつほう	抑圧法
よくあつてき	抑圧的
よくあつしゃ	抑圧者
よきんつうか	預金通貨
よきんこうざ	預金口座
よきょくいり	余曲入
よかかつどう	余暇活動
ようろういん	養老院
ようれんきん	溶連菌
ようりょくそ	葉緑素
ようりくかん	揚陸艦
ようようたい	幼葉態
ようもうざい	養毛剤
ようめいもん	陽明門
ようめいしゅ	養命酒
ようめいがく	陽明学
ようませんし	妖魔戦士
ようぼうしょ	要望書
ようぼうあん	要望案
ようへんこう	要変更
ようへいたい	傭兵隊
ようふくよう	洋服用
ようふくだい	洋服代
ようびよやく	曜日予約
ようひんてん	用品店	洋品店
ようねんへい	幼年兵
ようどがかり	用度掛
ようていざん	羊蹄山	羊帝山
ようちゅうい	要注意
ようちえんじ	幼稚園児
ようちあさが	夜討ち朝駆
ようそちょう	要素長
ようそしゅぎ	要素主義
ようせきりつ	容積率
ようせいぶん	要請文
ようせいたち	妖精達
ようせいぞく	妖精族
ようせいじょ	養成所
ようせいしょ	要請書
ようせいかい	妖精界
ようじんぼう	用心棒
ようじんぶか	用心深
ようじようご	用字用語
ようじあいて	幼児相手
ようしょくや	洋食屋
ようしょうじ	幼少時
ようしょうき	幼少期
ようしゅうり	要修理
ようしゃねが	容赦願
ようしゃくだ	容赦下
ようししゅう	要旨集
ようししてい	用紙指定
ようしきふう	洋式風
ようさいない	要塞内
ようさいとし	要塞都市
ようさいあと	要塞跡
ようごじてん	用語辞典
ようごじしょ	用語辞書
ようごしゅう	用語集
ようごしせつ	養護施設
ようごこうほ	用語候補
ようごきほう	用語記法
ようこうだい	洋光台
ようこうかん	要交換
ようけんどう	養賢堂
ようけんとう	要検討
ようきょうか	要強化
ようきゅうば	楊弓場
ようきちゅう	容器中
ようがしてん	洋菓子店
ようかんすう	陽関数
ようかくにん	要確認
ようかいねつ	溶解熱
ようかいちば	八日市場
ようかいせい	溶解性
ようかいえき	溶解液
ようえきるい	溶液類
よういちろう	陽一郎	曜一郎	洋一郎
よいまちぐさ	宵待草
ゆりもくぐん	ユリ目群
ゆりのちょう	百合野町
ゆりあげこう	閖上港
ゆらおんせん	由良温泉
ゆめみごこち	夢見心地
ゆめまぼろし	夢幻
ゆめぼうけん	夢冒険
ゆめはんだん	夢判断
ゆめでんせつ	夢伝説
ゆめこうぼう	夢工房
ゆめうらない	夢占い
ゆみはりづき	弓張り月
ゆふこうげん	由布高原
ゆびいっぽん	指一本
ゆにょうかん	輸尿管
ゆにゅうもの	輸入物
ゆにゅうもと	輸入元
ゆにゅうまい	輸入米
ゆにゅうぶつ	輸入物
ゆにゅうひん	輸入品
ゆにゅうばん	輸入盤	輸入版
ゆにゅうぜい	輸入税
ゆにゅうしょ	輸入書
ゆにゅうしゃ	輸入車	輸入者
ゆにゅうざい	輸入材
ゆだやきょう	ユダヤ教
ゆだなかえき	湯田中駅
ゆそうりょく	輸送力
ゆそうりょう	輸送量	輸送料
ゆそうひよう	輸送費用
ゆそうちゅう	輸送中
ゆそうじょう	輸送上
ゆそうぎょう	輸送業
ゆそうきょり	輸送距離
ゆそうきかん	輸送機関
ゆしゅつよう	輸出用
ゆしゅつひん	輸出品
ゆしゅつぜい	輸出税
ゆしゅつしゃ	輸出車
ゆしゅつさき	輸出先
ゆくえふめい	行方不明
ゆきわりそう	雪割草
ゆきれっしゃ	雪列車
ゆきみちよう	雪道用
ゆきまちづき	雪待ち月	雪待月
ゆきひらなべ	雪平鍋
ゆきのじょう	雪之丞
ゆきころがし	雪転がし
ゆきげしょう	雪化粧
ゆきがっせん	雪合戦
ゆかわひでき	湯川秀樹
ゆかめんせき	床面積
ゆかだんぼう	床暖房
ゆかたすがた	浴衣姿
ゆかしたよう	床下用
ゆかしたきき	床下機器
ゆかうんどう	床運動
ゆうわくせい	誘惑性
ゆうわくしゃ	誘惑者
ゆうろぴうむ	Eu	Europium
ゆうれいやく	幽霊役
ゆうれいせん	幽霊船
ゆうれいかぶ	幽霊株
ゆうりんどう	有隣堂
ゆうりんしゃ	友隣社
ゆうりょくば	有力馬
ゆうりょくし	有力視
ゆうりょうか	有料化	優良可
ゆうらんせん	遊覧船
ゆうらくてん	有楽店
ゆうらくがい	有楽街
ゆうよきかん	猶予期間
ゆうようてき	有用的
ゆうようせい	有用性
ゆうもうせん	湧網線
ゆうめいてん	有名店
ゆうめいじん	有名人
ゆうめいしょ	有名所
ゆうめいこく	有名国
ゆうめいこう	有名校
ゆうめいかい	幽冥界
ゆうみんしゃ	遊眠社	遊民社
ゆうぼくみん	遊牧民
ゆうぼうかぶ	有望株
ゆうべつえき	湧別駅
ゆうふつぐん	勇払郡
ゆうびんぶつ	郵便物
ゆうびんばこ	郵便箱
ゆうびんだい	郵便代
ゆうびんじこ	郵便事故
ゆうびんしゃ	郵便車
ゆうびんうけ	郵便受け
ゆうひょうき	融氷期
ゆうひょうか	優評価
ゆうばくじこ	誘爆事故
ゆうはつざい	誘発剤
ゆうどくぶつ	有毒物
ゆうどくせい	有毒性
ゆうどうだん	誘導弾
ゆうどうたい	誘導体
ゆうどうがた	誘導型
ゆうとうせい	優等生
ゆうとうしゃ	優等車
ゆうとうぐん	雄踏郡
ゆうでんりつ	誘電率
ゆうでんたい	誘電体
ゆうづうせい	融通性
ゆうだんしゃ	有段者
ゆうだちぐも	夕立雲
ゆうたいるい	有袋類
ゆうたいぶつ	有体物
ゆうたいけん	優待券
ゆうそうぶつ	郵送物
ゆうそうだい	郵送代
ゆうそうさき	郵送先
ゆうそういた	郵送致
ゆうぜんぞめ	友禅染
ゆうせんわく	優先枠
ゆうせんどう	優先道
ゆうせんてき	優先的
ゆうせんせき	優先席
ゆうせんしき	有線式
ゆうせんけん	優先権
ゆうせんがわ	優先側
ゆうせんかぶ	優先株
ゆうせつざい	融雪剤
ゆうせきせい	有責性
ゆうせいらん	有精卵
ゆうせいぞく	郵政族
ゆうせいしゃ	遊星社
ゆうせいがち	優勢勝ち
ゆうせいがく	優生学
ゆうせいおん	有声音
ゆうずうむげ	融通無碍
ゆうじんぶん	友人分
ゆうじんとう	有人島
ゆうじんたち	友人達
ゆうじんたく	友人宅
ゆうじんかん	友人間
ゆうじんえき	有人駅
ゆうしんろん	有神論
ゆうしょうば	優勝馬
ゆうしょうご	優勝後
ゆうしょうき	優勝旗
ゆうしゃたち	勇者達
ゆうしきしゃ	有識者
ゆうざんかく	雄山閣
ゆうごうてき	融合的
ゆうごうけん	融合研
ゆうごうけい	融合型
ゆうごうがた	融合型
ゆうこうへん	有向辺
ゆうこうてき	有効的	友好的
ゆうこうせい	有効性
ゆうこうすう	有効数
ゆうこうこく	友好国
ゆうこうけた	有効桁
ゆうこうがそ	有効画素
ゆうこうえだ	有向枝
ゆうげんれつ	有限列
ゆうげんてき	有限的
ゆうげんせい	有限性
ゆうげんぐん	有限群
ゆうげんかい	有限回
ゆうげきたい	遊撃隊
ゆうげきせん	遊撃戦
ゆうげきしゅ	遊撃手
ゆうけんしゃ	有権者
ゆうぐうそち	優遇措置
ゆうぎちゅう	遊技中
ゆうぎじょう	遊戯場	遊技場
ゆうぎきんし	遊技禁止
ゆうきゅうち	遊休地
ゆうきつむぎ	結城紬
ゆうききんこ	有期禁錮
ゆうきかがく	有機化学
ゆうがたびん	夕方便
ゆうがたはつ	夕方発
ゆうがたごろ	夕方頃
ゆうかいもの	誘拐物
ゆうかいはん	誘拐犯
ゆうかいねつ	融解熱
ゆうかいてん	融解点
ゆうかいだん	優階段
ゆうかいざい	誘拐罪
ゆうえつこう	優越項
ゆうえつかん	優越感
ゆうえきせい	有益性
ゆううつしつ	憂鬱質
ゆういちろう	勇一郎	有一郎	祐一郎	裕一郎	雄一郎
ゆいめいろん	唯名論
ゆいまぎょう	維摩経
ゆいぶつろん	唯物論
ゆいびしゅぎ	唯美主義
ゆいのうろん	唯脳論
ゆいのうひん	結納品
ゆいのうしき	結納式
ゆいのうきん	結納金
ゆいしんろん	唯神論	唯心論
ゆいしょただ	由緒正
ゆいしきろん	唯識論
ゆいごんにん	遺言人
ゆいごんしょ	遺言書
ゆいいつむに	唯一無二
ゆいいつせい	唯一性
ゆあさでんち	湯浅電池
ゆーざーかい	ユーザー会
やんろんちゃ	燕龍茶
やんぬるかな	已んぬる哉
やろうどうし	野郎同士
やろうじだい	夜郎自大
やりてむすび	遣り手結び
やらいちょう	矢来町
やよいぶんか	弥生文化
やよいちょう	弥生町
やよいじだい	弥生時代
やよいしょう	弥生賞
やもうしょう	夜盲症
やみとりひき	闇取引
やみきんゆう	闇金融
やまようひん	山用品
やまもももく	Myricales	ヤマモモ目
やまもとやま	山本山
やまもとけん	山本研
やまぶきいろ	山吹色
やまふところ	山懐
やまばといろ	山鳩色
やまのてせん	山手線
やまのがっき	山野楽器
やまなしだい	山梨大
やまなしけん	山梨県
やまなしがわ	山梨側
やまなかごえ	山中越
やまとたける	日本武尊
やまとたかだ	大和高田
やまとしみん	大和市民
やまとことば	大和言葉
やまとおおじ	大和大路
やまとうんゆ	ヤマト運輸
やまでらかん	山寺間
やまだようじ	山田洋次
やまだにしき	山田錦
やまだいすず	山田五十鈴
やまだいこう	山大工
やまたかぼう	山高帽
やまたいこく	邪馬臺国	邪馬台国
やましなえき	山科駅
やましたけん	山下研
やまぐるまか	Trochodendraceae	ヤマグルマ科
やまぐちだい	山口大
やまぐちせん	山口線
やまぐちけん	山口県
やまがたふう	山形風
やまがたばん	山形版
やまがただい	山形大
やまがたけん	山形県
やまがたきた	山形北
やまがたがわ	山形側
やまがたかん	山形間
やまがたえき	山形駅
やまかんむり	山冠
やまいもあめ	山芋飴
やぶれかぶれ	破れかぶれ
やはたひがし	八幡東
やはたしかん	八幡市間
やはたしえき	八幡市駅
やねこうばい	屋根勾配
やねうらべや	屋根裏部屋
やなぎちょう	柳町
やながわなべ	柳川鍋
やつゆうえん	谷津遊園
やつめうなぎ	八目鰻	鱧
やっこどうふ	奴豆腐
やっこそうか	Rafflesiaceae	ヤッコソウ科
やっかさえき	薬価差益
やっかいもの	厄介者
やっかいごと	厄介事
やちんほじょ	家賃補助
やたのかがみ	八咫鏡
やそうきょく	夜想曲
やせいじだい	野生時代	野性時代
やすみちゅう	休み中
やすみじかん	休み時間
やすだなるみ	安田成美
やすだきねん	安田記念
やすだかさい	安田火災
やすくにどお	靖国通
やすうけあい	安請合い	安請け合い
やすいちろう	靖一郎
やじるしきー	矢印キー
やしもくぐん	ヤシ目群
やさかりゅう	八坂流	屋坂流
やさいさらだ	野菜サラダ
やさいうりば	野菜売場
やさいいちば	野菜市場
やさいいため	野菜炒め
やこうちゅう	夜光虫	夜行虫
やけぼっくい	焼け棒杭
やけいこっか	夜警国家
やぐるまそう	矢車草
やぐるまぎく	矢車菊
やくりさよう	薬理作用
やくまんれき	役満歴
やくまんがん	役満貫
やくひんくさ	薬品臭
やくはんぶん	約半分
やくはんとし	約半年
やくはんすう	約半数
やくはんがく	約半額
やくにんたち	役人達
やくにんさま	役人様
やくどうかん	躍動感
やくそくどお	約束通
やくそくごと	約束事
やくそうがく	薬草学
やくしょかん	役所間
やくしゃばか	役者馬鹿
やくしゃたち	役者達
やくいんだん	役員団
やくいんしつ	役員室
やくいんかい	役員会
やくいちめい	約一名
やくいちにち	約一日
やぎゅうばし	柳生橋
やきんじゅつ	冶金術
やきゅうつう	野球通
やきゅうだん	野球団
やきゅうずき	野球好き
やきゅうじん	野球人
やきゅうけん	野球拳
やきゅうかん	野球観
やきゅうかい	野球界
やきはまぐり	焼き蛤	焼蛤
やきにくよう	焼肉用
やきにくてん	焼肉店
やきぎょうざ	焼餃子	焼き餃子
やかけちょう	矢掛町
やおくうこう	八尾空港
やえすむせん	八重洲無線
やえいじょう	野営場
よんりんくどう	四輪駆動
よんとうごらく	四当五落
よんしゅうかん	四週間
よんげんそせつ	四元素説
よろんゆうどう	世論誘導
よろんちょうさ	世論調査
よよぎこうえん	代々木公園
よよぎうえはら	代々木上原
よやくまどぐち	予約窓口
よやくほうしき	予約方式
よやくへんこう	予約変更
よやくびんめい	予約便名
よやくばんごう	予約番号
よやくはんばい	予約販売
よやくないよう	予約内容
よやくとくてん	予約特典
よやくせってい	予約設定
よやくじじょう	予約事情
よやくこうどく	予約講読	予約購読
よやくかんけい	予約関係
よやくかいしび	予約開始日
よやくうけつけ	予約受付
よもやまばなし	四方山話
よめしゅうとめ	嫁姑
よみびとしらず	詠人不知
よみうりらんど	読売ランド
よみうりびいき	読売贔屓
よみうりにほん	読売日本
よぼうほうほう	予防方法
よぼうせんそう	予防戦争
よぼうせっしゅ	予防接種
よぼういりょう	予防医療
よびとうひょう	予備投票
よびだしふごう	呼出符号	呼出符合
よびせんりょく	予備戦力
よびじょうほう	予備情報
よびしんさかい	予備審査会
よにんしょうぎ	四人将棋
よなごくうこう	米子空港
よないみつまさ	米内光政
よどがわかこう	淀川河口
よていへんこう	予定変更
よていのうぜい	予定納税
よていにんずう	予定人数
よていないよう	予定内容
よていちょうわ	予定調和
よていしゃめい	予定者名
よつやほうめん	四谷方面
よつやほうこう	四谷方向
よつやかいだん	四谷怪談
よっかいちえき	四日市駅
よちのうりょく	予知能力
よだんかつよう	四段活用
よそくふかのう	予測不可能
よそうもんだい	予想問題
よそうほうほう	予想方法
よそうにんずう	予想人数
よそうじゅんい	予想順位
よそうしゃめい	予想者名
よそうけいしき	予想形式
よそうかそくど	予想加速度
よそうかくりつ	予想確率
よそういじょう	予想以上
よせんめんじょ	予選免除
よせんふつかめ	予戦二日目
よせんぜんじつ	予選前日
よせんじゅんい	予選順位
よせんさいかい	予選最下位
よせつくうかん	余接空間
よじょうぶぶん	余剰部分
よじょうきざい	余剰器材
よしはらせいゆ	吉原製油
よしのじんぐう	吉野神宮
よしのさくぞう	吉野作造
よしながさゆり	吉永小百合
よしだせんしゃ	吉田戦車
よしだけんこう	吉田兼好
よさんはいぶん	予算配分
よさんちょうか	予算超過
よさんさくげん	予算削減
よさんかんけい	予算関係
よさんかくだい	予算拡大
よさのてっかん	与謝野鉄幹
よこみつりいち	横光利一
よこみぞせいし	横溝正史
よこはましみん	横浜市民
よこはましない	横浜市内
よこはましてん	横浜支店
よこはましえい	横浜市営
よこはまいえん	横浜以遠
よこなががめん	横長画面
よこづなずもう	横綱相撲
よこづなきゅう	横綱級
よこすかどうろ	横須賀道路
よこじくじょう	横軸上
よこくかんばん	予告看板
よこがわでんき	横河電機
よこかわでんき	横河電気
よこうげんこう	予稿原稿
よくりゅうしゃ	抑留者
よくようとんざ	抑揚頓挫
よくせいこうか	抑制効果
よくげつばらい	翌月払い
よくうつしょう	抑鬱症
よきんとうけつ	預金凍結
よきんしゅもく	預金種目
よきんざんだか	預金残高
ようろうほけん	養老保険
ようろうのたき	養老の滝
ようれつぐどん	庸劣愚鈍
ようれいしゅう	用例集
ようりょくたい	葉緑体
ようりょうてき	容量的
ようやくひっき	要約筆記
ようやくきのう	要約機能
ようむいんしつ	用務員室
ようみゃくけい	葉脈系
ようまたんちき	妖魔探知機
ようぼうようし	容貌容姿
ようぼうじこう	要望事項
ようぼうかいい	容貌魁偉
ようほうじばん	要法寺版
ようふくだんす	洋服箪笥
ようねんじだい	幼年時代
ようとへんこう	用途変更
ようとうくにく	羊頭狗肉
ようついますい	腰椎麻酔
ようちえんせい	幼稚園生
ようちあさがけ	夜討ち朝駆け
ようそぶんかつ	要素分割
ようそばんごう	要素番号
ようそしきべつ	要素識別
ようそぎじゅつ	要素技術
ようそうろんり	様相論理
ようせいちゅう	養成中
ようせいしせつ	養成施設
ようせいきかん	養成機関
ようじょうたい	葉状体
ようじばんぐみ	幼児番組
ようじたいけん	幼児体験
ようじたいけい	幼児体型
ようしょくよう	養殖用
ようしょくもの	養殖物
ようしょくぎょ	養殖魚
ようしょくうお	養殖魚
ようしょうりば	洋書売場
ようしたんれい	容姿端麗
ようしせってい	用紙設定
ようしきべんき	洋式便器
ようしきじょう	様式上
ようしかくにん	容姿確認
ようしえんぐみ	養子縁組
ようさんぎょう	養蚕業
ようごだんたい	養護団体
ようごせつめい	用語説明
ようごきょうゆ	養護教諭
ようごがっこう	養護学校
ようごかくてい	用語確定
ようこうしゅう	要項集
ようこうぐてん	洋工具店
ようけんじじつ	要件事実
ようけいじょう	養鶏場
ようぎょじょう	養魚場
ようきょくせん	陽極線
ようきょくがわ	陽極側
ようきゅうまち	要求待ち
ようきゅうぶん	要求文
ようきゅうぶつ	要求物
ようきゅうひん	要求品
ようきゅうなど	要求等
ようきゅうてん	楊弓店
ようきゅうしょ	要求書
ようきゅうしゃ	要求者
ようきゅうしつ	要求室
ようきゅうがわ	要求側
ようきゅうがく	要求額
ようかいへんげ	妖怪変化
ようえきちゅう	溶液中
よういんりろん	要因理論
ゆりょうほうふ	湯量豊富
ゆりもくあぐん	ユリ目亜群
ゆりあにあもく	ユリアニア目	Julianiales
ゆめものがたり	夢物語
ゆめのうきはし	夢浮橋
ゆむらおんせん	湯村温泉
ゆまくいじょう	油膜以上
ゆびにんぎょう	指人形
ゆのみぢゃわん	湯呑み茶碗	湯飲み茶碗
ゆにゅうりょう	輸入量
ゆにゅうひよう	輸入費用
ゆにゅうばんや	輸入盤屋
ゆにゅうしょう	輸入商
ゆにゅうきんし	輸入禁止
ゆたかしょうゆ	豊醤油
ゆそうほごよう	輸送保護用
ゆそうほうほう	輸送方法
ゆそうじんいん	輸送人員
ゆそうじゅよう	輸送需要
ゆそうじっせき	輸送実績
ゆそうしゅだん	輸送手段
ゆそうけいさん	輸送計算
ゆそうけいかく	輸送計画
ゆずりうけにん	譲受人
ゆずとうがらし	柚唐辛子
ゆしゅつにゅう	輸出入
ゆしゅつしよう	輸出仕様
ゆしゅつしょう	輸出商
ゆしゅつきせい	輸出規制
ゆしめんしょく	諭旨免職
ゆしまてんじん	湯島天神
ゆきだるましき	雪達磨式
ゆきぐにいがい	雪国以外
ゆかわおんせん	湯川温泉
ゆうわせいさく	融和政策	宥和政策
ゆうわぎじゅつ	融和技術
ゆうれいやしき	幽霊屋敷
ゆうれいぶいん	幽霊部員
ゆうれいたいじ	幽霊退治
ゆうりょくしゃ	有力者
ゆうりょくこう	有力校
ゆうりょくかぶ	有力株
ゆうりょうひん	優良品
ゆうりょうてん	優良店
ゆうりょうぜい	遊漁税
ゆうりょうせい	優良性
ゆうりょうかぶ	優良株
ゆうりすうたい	有理数体
ゆうりかんすう	有理関数
ゆうらんひこう	遊覧飛行
ゆうらくちょう	有楽町
ゆうゆうじてき	悠悠自適	悠々自適
ゆうやけこやけ	夕焼小焼
ゆうめいりきし	有名力士
ゆうめいむじつ	有名無実
ゆうめいどころ	有名所
ゆうめいじいん	有名寺院
ゆうめいかしゅ	有名歌手
ゆうびんりょう	郵便料
ゆうびんせいど	郵便制度
ゆうびんきょく	郵便局
ゆうびんきって	郵便切手
ゆうびんかわせ	郵便為替
ゆうはつでんい	誘発電位
ゆうどかんすう	尤度関数
ゆうどうがかり	誘導係
ゆうでんかねつ	誘電加熱
ゆうちうんどう	誘致運動
ゆうたいりだつ	幽体離脱
ゆうたいかかく	優待価格
ゆうそくこじつ	有職故実
ゆうそうりょう	郵送料
ゆうそうきぼう	郵送希望
ゆうせんよやく	優先予約
ゆうせんどうろ	優先道路
ゆうせんでんわ	有線電話
ゆうせんじゅん	優先順
ゆうせんじこう	優先事項
ゆうせいせだい	有性世代
ゆうせいしょう	郵政省
ゆうせいしいん	有声子音
ゆうせいいでん	優性遺伝
ゆうじんどうし	友人同士
ゆうじんつうろ	有人通路
ゆうじんちゅう	友人中
ゆうじんちじん	友人知人
ゆうしょくよう	夕食用
ゆうしょくどき	夕食時
ゆうしょくだい	夕食代
ゆうしょくしゃ	有職者
ゆうしょくかい	夕食会
ゆうしょうはい	優勝杯
ゆうしょうせん	優勝戦
ゆうしょうしゃ	優勝者	優勝車
ゆうしょうこう	優勝校
ゆうしゅうのび	有終の美
ゆうしゅうだい	優秀台
ゆうしゅうせい	優秀性
ゆうしゅうしゃ	優秀者
ゆうしてっせん	有刺鉄線
ゆうしかくしゃ	有資格者
ゆうさいしょく	有彩色
ゆうごうぶんや	融合分野
ゆうこうりよう	有効利用
ゆうこうりょう	有効量
ゆうこうびっと	有効ビット
ゆうこうひょう	有効票
ゆうこうはんい	有効範囲
ゆうこうちょう	有効長
ゆうこうちゅう	有孔虫
ゆうこうだすう	有効打数
ゆうこうそくど	有効速度
ゆうこうすうじ	有効数字
ゆうこうきょり	有効距離
ゆうこうきげん	有効期間	有効期限
ゆうこうきかん	有効期間
ゆうげんちょう	有限長
ゆうげんしげん	有限資源
ゆうげんおんど	有限温度
ゆうけいりょく	有形力
ゆうけいむけい	有形無形
ゆうぎしゃすう	遊戯者数
ゆうきようばい	有機溶媒
ゆうきようざい	有機溶剤
ゆうきょうでん	遊侠伝
ゆうきゅうすう	優級数
ゆうきひりょう	有機肥料
ゆうきのうほう	有機農法
ゆうきさいばい	有機栽培
ゆうきごうせい	有機合成
ゆうがびみょう	優雅微妙
ゆうがたいこう	夕方以降
ゆうがいむえき	有害無益
ゆうがいとしょ	有害図書
ゆうがいしてい	有害指定
ゆうかんまだむ	有閑マダム
ゆうかんぶぶん	有感部分
ゆうかんふじん	有閑夫人
ゆうかんじしん	有感地震
ゆうかいようぎ	誘拐容疑
ゆうかいじけん	誘拐事件
ゆうかいくかん	有界区間
ゆうおんくかん	有音区間
ゆうえんちけん	遊園地券
ゆいぶつしかん	唯物史観
ゆいしょうせつ	由井小説
ゆいごんじょう	遺言状
ゆいがどくそん	唯我獨尊	唯我独尊
やんばるくいな	山原水鶏
やるたかいだん	ヤルタ会談
やよいしきどき	弥生式土器
やみりょうがえ	闇両替
やみしょうばい	闇商売
やみきょういく	闇教育
やまもとひろし	山本弘
やまもとちょう	山本丁
やまもとこうじ	山本浩二
やまもがしもく	ヤマモガシ目	Proteales
やまむらがらす	山村硝子
やまぶきちょう	山吹町
やまはいじこみ	山廃仕込み
やまのぼりほう	山登り法
やまのうちけん	山之内研
やまとみんぞく	大和民族
やまとなでしこ	大和撫子
やまとだましい	大和魂
やまとそうけん	大和総研
やまとぐさもく	Theligonales	ヤマトグサ目
やまてせんない	山手線内
やまだしょいん	山田書院
やまだこうさく	山田耕筰
やまだおんせん	山田温泉
やまたのおろち	八岐大蛇	八岐の大蛇	八俣之大蛇	八俣の大蛇
やましななんぶ	山科南部
やましたふとう	山下埠頭
やまざきひろこ	山崎浩子
やまぐちももえ	山口百恵
やまぐちさよこ	山口小夜子
やまがたひがし	山形東
やまがたざおう	山形蔵王
やまがたいえん	山形以遠
やまいこうこう	病膏肓
やはたていしゃ	八幡停車
やはたしょてん	八幡書店
やにょうしょう	夜尿症
やなぎたくにお	柳田国男
やなぎさわえき	柳沢駅
やながわしない	柳川市内
やどじょうほう	宿情報
やっつけしごと	遣っ付け仕事
やっこそうもく	ヤッコソウ目	Rafflesiales
やっきょくほう	薬局方
やっかだいがく	薬科大学
やっかきじゅん	薬価基準
やせいどうぶつ	野生動物
やすだこうどう	安田講堂
やすだきねんば	安田記念馬
やすげっきゅう	安月給
やすくにどおり	靖国通り
やすかわでんき	安川電機
やしゅせんたく	野手選択
やさかじんじゃ	八坂神社
やさいりょうり	野菜料理
やこうれっしゃ	夜行列車
やこうしんだい	夜行寝台
やこうこうそく	夜行高速
やこうかいそく	夜行快速
やけびたいさん	焼額山
やぐちのわたし	矢口渡
やくもがくえん	八雲学園
やくぶつしょじ	薬物所持
やくびょうがみ	厄病神	疫病神
やくひんしゅう	薬品臭
やくそくてがた	約束手形
やくじょうしょ	約定書
やくしょしごと	役所仕事
やくしょくめい	役職名
やくしゅしょう	薬種商
やくしゃちゅう	訳者注
やくしにょらい	薬師如来
やきょうしょう	夜驚症
やきゅうようご	野球用語
やきゅうまんが	野球漫画
やきゅうぶいん	野球部員
やきゅうじょう	野球場
やきゅうしあい	野球試合
やきゅうこぞう	野球小僧
やきゅうきょう	野球狂
やきゅうきこう	野球機構
やきみょうばん	焼明礬
やきびたいやま	焼額山
やがいりょうり	野外料理
やがいかつどう	野外活動
やかんとうせき	夜間透析
やおんほうめん	野音方面
やえすちかがい	八重洲地下街
やいづえきまえ	焼津駅前
よんしゃたくいつ	四者択一
よんこうかんけい	4項関係
よろずちょうほう	万朝報
よりあいじょたい	寄り合い所帯
よやくりょういき	予約領域
よやくしゅっぱん	予約出版
よやくこうにゅう	予約購入
よみうりしんぶん	読売新聞
よみうりけいれつ	読売系列
よみうりきょじん	読売巨人
よぼうちゅうしゃ	予防注射
よびしはらいにん	予備支払人
よっきゅうふまん	欲求不満
よちかんそくしつ	予知観測室
よそくのうりょく	予測能力
よせんつうかしゃ	予選通過者
よせんかいじょう	予選会場
よじげんくうかん	四次元空間
よしだしょういん	吉田松陰
よしだこうぎょう	吉田工業
よしおかしょてん	吉岡書店
よざくらこうえん	夜桜公園
よさんとうにゅう	予算投入
よさんいいんかい	予算委員会
よこやまたいかん	横山大観
よこはまもとまち	横浜元町
よこはまみつこし	横浜三越
よこはまほうめん	横浜方面
よこはまにしぐち	横浜西口
よこはまたいよう	横浜大洋
よこはまたいかい	横浜大会
よこはましんどう	横浜新道
よこはまこくだい	横浜国大
よこはまこうほく	横浜港北
よこはまこうえん	横浜公演
よこはまぎんこう	横浜銀行
よこはまきんこう	横浜近郊
よこはまありーな	横浜アリーナ
よこづなすいせん	横綱推薦
よこすかつうけん	横須賀通研
よこしほうがため	横四方固め
よこくひょうしき	予告標識
よこうれんしゅう	予行練習
よこうしゅうだい	予稿集代
よこうえんしゅう	予行演習
よくとしいっぱい	翌年一杯
よくせいぶっしつ	抑制物質
よくせいせいそし	抑制性素子
よくせいしゅほう	抑制手法
よくせいさいぼう	抑制細胞
よくせいさいばい	抑制栽培
よくじつゆうがた	翌日夕方
よくあつしゅほう	抑圧手法
よきんつうちょう	預金通帳
ようりょうぶそく	容量不足
ようりょうどおり	容量通り
ようりょうぞうか	容量増加
ようりょうかんり	容量管理
ようりょうかくほ	容量確保
ようめいてんのう	用明天皇
ようぼうないよう	要望内容
ようぶつけいやく	要物契約
ようふうけんちく	洋風建築
ようでんしずのう	陽電子頭脳
ようちゅうじだい	幼虫時代
ようちばいしゅう	用地買収
ようちえんじだい	幼稚園時代
ようぜいてんのう	陽成天皇
ようせんけいやく	傭船契約
ようせいまきひげ	葉性巻きひげ	葉性巻鬚
ようせいがっこう	養成学校
ようじきょういく	幼児教育
ようしょようしょ	要所要所
ようしょくじょう	養殖場
ようしゅうりひん	要修理品
ようしほうしゅつ	陽子放出
ようさいとっこう	要塞特攻
ようさいこうげき	要塞攻撃
ようきゅうどおり	要求通り
ようきゅうていぎ	要求定義
ようきゅうちゅう	要求中
ようきゅうじこう	要求事項
ようきゅうしよう	要求仕様
ようきゅうしょり	要求処理
ようきゅうくどう	要求駆動
ようきゅうきのう	要求機能
ようがげきじょう	洋画劇場
よういしゅうとう	用意周到
ゆめのきゅうさく	夢野久作
ゆびわものがたり	指輪物語
ゆびさしかくにん	指差確認
ゆびいっぽんぶん	指一本分
ゆのはまおんせん	湯野浜温泉
ゆにゅうばんてん	輸入盤店
ゆにゅうはんばい	輸入販売
ゆにゅうちょうか	輸入超過
ゆにゅうだいこう	輸入代行
ゆにゅうせんもん	輸入専門
ゆにゅうじゆうか	輸入自由化
ゆにゅうしゅぼば	輸入種牡馬
ゆそうのうりょく	輸送能力
ゆそうぎょうしゃ	輸送業者
ゆずりわたしにん	譲渡人
ゆしゅつちょうか	輸出超過
ゆしゅつぜんたい	輸出全体
ゆけんこうぎょう	油研工業
ゆくえふめいしゃ	行方不明者
ゆうれいれっしゃ	幽霊列車
ゆうれいじんこう	幽霊人口
ゆうれいがいしゃ	幽霊会社
ゆうりょくこうほ	有力候補
ゆうりょうどうろ	有料道路
ゆうりすうじょう	有理数上
ゆうりきょうかい	有理境界
ゆうめいむじつか	有名無実化
ゆうめいはいゆう	有名俳優
ゆうめいせんしゅ	有名選手
ゆうぼくみんぞく	遊牧民族
ゆうびんふりこみ	郵便振込
ゆうびんふりかえ	郵便振替
ゆうびんばんごう	〒	郵便番号
ゆうびんはいたつ	郵便配達
ゆうびんでんしゃ	郵便電車
ゆうびんちょきん	郵便貯金
ゆうびんそくたつ	郵便速達
ゆうびんしょかん	郵便書簡
ゆうびんこづつみ	郵便小包
ゆうびんこがわせ	郵便小為替
ゆうどくぶっしつ	有毒物質
ゆうどくせいぶん	有毒成分
ゆうどうじんもん	誘導尋問
ゆうどうざつおん	誘導雑音
ゆうどうえんぼく	遊動円木
ゆうとうれっしゃ	優等列車
ゆうとうせいてき	優等生的
ゆうでんそんしつ	誘電損失
ゆうたいばんるい	有胎盤類
ゆうたいどうさん	有体動産
ゆうそうさいぼう	遊走細胞
ゆうせんろしゅつ	優先露出
ゆうせんほうそう	有線放送
ゆうせんはんばい	優先販売
ゆうせんでんわき	有線電話機
ゆうせんつうしん	有線通信
ゆうせんたんさく	優先探索
ゆうせんそうしん	有線送信
ゆうせんじゅんい	優先順位
ゆうせんしんごう	優先信号
ゆうせんきじゅん	優先基準
ゆうせんかいせん	有線回線
ゆうせんかいけつ	優先解決
ゆうせいほごほう	優生保護法
ゆうせいだいじん	郵政大臣
ゆうせいこうしゃ	郵政公社
ゆうじんまどぐち	有人窓口
ゆうじんしょゆう	友人所有
ゆうじんかんけい	友人関係
ゆうじんかいさつ	有人改札
ゆうじんいちどう	友人一同
ゆうじゅうふだん	優柔不断
ゆうしょうよそう	優勝予想
ゆうしょうこうほ	優勝候補
ゆうしょうこうい	有償行為
ゆうしょうきょく	優勝曲
ゆうしょうきねん	優勝祈念	優勝記念
ゆうしょういがい	優勝以外
ゆうしょうあらそ	優勝争
ゆうしゅんひんば	優駿牝馬
ゆうしゅうしょう	優秀賞
ゆうしつどうぶつ	有櫛動物
ゆうしじょうけん	融資条件
ゆうざいはんけつ	有罪判決
ゆうごうがったい	融合合体
ゆうこうまいすう	有効枚数
ゆうこうとくてん	有効得点
ゆうこうてんれつ	有向点列
ゆうこうせんぶん	有向線分
ゆうこうせいぶん	有効成分
ゆうこうじゅよう	有効需要
ゆうこうこうけい	有効口径
ゆうこうけたすう	有効桁数
ゆうこうがそすう	有効画素数
ゆうこうかんけい	友好関係
ゆうこうかつよう	有効活用
ゆうげんだいすう	有限代数
ゆうげんせきにん	有限責任
ゆうげんすうれつ	有限数列
ゆうげんじっこう	有言実行
ゆうげんけいれつ	有限系列
ゆうげんぐんろん	有限群論
ゆうげんがいしゃ	有限会社
ゆうげんいっぱん	有限一般
ゆうけんしゃぞう	有権者像
ゆうけんしゃすう	有権者数
ゆうけっていけい	優決定系
ゆうぐうぜいせい	優遇税制
ゆうぎりょうほう	遊戯療法
ゆうぎりょうきん	遊技料金
ゆうきゅうしさん	遊休資産
ゆうきちょうえき	有期懲役
ゆうきかごうぶつ	有機化合物
ゆうがいぶっしつ	有害物質
ゆうかしょうけん	有価証券
ゆうかいほうどう	誘拐報道
ゆうかいへんどう	有界変動
ゆうかいはんにん	誘拐犯人
ゆうかいさつじん	誘拐殺人
ゆうおうまいしん	勇徃邁進	勇往邁進
ゆういすいじゅん	有意水準
ゆういさけんてい	有意差検定
ゆいぶつろんてき	唯物論的
ゆいいつぜったい	唯一絶対
やよいじだいごろ	弥生時代頃
やまわきがくえん	山脇学園
やまもとゆうぞう	山本有三
やまもとかんさい	山本寛斎
やまもといそろく	山本五十六
やまべのあかひと	山部赤人
やまははつどうき	ヤマハ発動機
やまのてせんない	山手線内
やまなしほうそう	山梨放送
やまなしとくゆう	山梨特有
やまなしだいがく	山梨大学
やまなしけんない	山梨県内
やまなしけんじん	山梨県人
やまなしけんがわ	山梨県側
やまとものがたり	大和物語
やまとちょうてい	大和朝廷
やまとこおりやま	大和郡山
やまとこうぎょう	大和工業
やまとおうちょう	大和王朝
やまてかもつせん	山手貨物線
やましろこうこう	山城高校
やましろおんせん	山代温泉
やましなほうめん	山科方面
やましたたつろう	山下達郎
やましたしょてん	山下書店
やましたこうえん	山下公園
やまざきせいぱん	山崎製パン
やまぐちほうそう	山口放送
やまぐちだいがく	山口大学
やまぐちけんない	山口県内
やまがたほうめん	山形方面
やまがたほうそう	山形放送
やまがただいこう	山形大工
やまがただいがく	山形大学
やまがたけんない	山形県内
やまがたぎんこう	山形銀行
やまがたありとも	山県有朋
やなぎもくあぐん	ヤナギ目亜群
やなぎばとしろう	柳葉敏郎
やっこうはつげん	薬効発現
やちんほじょがく	家賃補助額
やせんこうじょう	野戦攻城
やすくにじんじゃ	靖国神社
やじるしほうこう	矢印方向
やじるししんごう	矢印信号
やさいほぞんよう	野菜保存用
やこびぎょうれつ	ヤコビ行列
やこうとっきゅう	夜行特急
やこうきゅうこう	夜行急行
やけどじょうたい	火傷状態
やくわりぶんたん	役割分担
やくわりいっぱん	役割一般
やくるとほんしゃ	ヤクルト本社
やくぶつはんのう	薬物反応
やくはんとしまえ	約半年前
やくぜんりょうり	薬膳料理
やくじょうりりつ	約定利率
やくじょうりそく	約定利息
やくじほういはん	薬事法違反
やくしまるひろこ	薬師丸ひろ子
やくいんしょうよ	役員賞与
やぎゅうさんだい	柳生三代
やぎゅういちぞく	柳生一族
やきんこうぎょう	冶金工業
やきゅうようひん	野球用品
やきゅうほんらい	野球本来
やきゅうたいかい	野球大会
やきゅうせんしゅ	野球選手
やきゅうしんぶん	野球新聞
やきゅうかんれん	野球関連
やきゅうかんせん	野球観戦
やきゅうおうこく	野球王国
やかんでんりょく	夜間電力
やかんそうこうご	夜間走行後
やえすみなみぐち	八重洲南口
やえすしゅっぱん	八重洲出版
やいづちゅうおう	焼津中央
よんりんくどうしゃ	四輪駆動車
よんじゅうそうばん	四重奏番
よんじゅうじんかく	四重人格
よろずやきんのすけ	萬屋錦之介
よゆうしゃくしゃく	余裕綽綽
よやくろくがきのう	予約録画機能
よやくじょうきょう	予約状況
よみうりちょうかん	読売朝刊
よびしゃけんじょう	予備車検場
よびこうしゅうかい	予備講習会
よどがわかせんじき	淀川河川敷
よていちょうわてき	予定調和的
よつやさんちょうめ	四谷三丁目
よっきゅうじつげん	欲求実現
よっかいちほうめん	四日市方面
よっかいちぜんそく	四日市喘息
よそくかいてんすう	予測回転数
よそうかんせいじき	予想完成時期
よせんだいいっせん	予選第一戦
よせんいっかいせん	予選一回戦
よじょうでんりょく	余剰電力
よしもとしんきげき	吉本新喜劇
よしもとこうぎょう	吉本興業
よこはままつざかや	横浜松坂屋
よこはまとうきゅう	横浜東急
よこはまたかしまや	横浜高島屋
よこはましりつだい	横浜市立大
よこはましないえき	横浜市内駅
よこはまこうじょう	横浜工場
よこはまけいむしょ	横浜刑務所
よこづなしょうしん	横綱昇進
よこじくざひょうち	横軸座標値
よこかぜちゃくりく	横風着陸
よこいっちょくせん	横一直線
よくしつかんそうき	浴室乾燥機
よきんほけんせいど	預金保険制度
よきんほけんきこう	預金保険機構
ようりょくけいすう	揚力係数
ようりょうひょうじ	容量表示
ようりょうせってい	容量設定
ようりょうせいげん	容量制限
ようりょうげんかい	容量限界
ようりょうけいかく	容量計画
ようりょういっぱい	容量一杯
ようとべつてきせい	用途別適性
ようちゅういかしょ	要注意箇所
ようちえんきょうゆ	幼稚園教諭
ようせいせいしょく	幼生生殖
ようすいちえきけん	用水地役権
ようしょてんかかく	洋書店価格
ようけいせいじゅく	幼形成熟
ようきゅうめいれい	要求命令
ようきゅうぶんせき	要求分析
ようきゅうないよう	要求内容
ようきゅうせいのう	要求性能
ようきゅうこうもく	要求項目
ようきほあんきそく	容器保安規則
ようかいごにんてい	要介護認定
よういくがっきゅう	養育学級
よいんしぎょうれつ	余因子行列
ゆらがわてっきょう	由良川鉄橋
ゆにゅうばんめあて	輸入盤目当
ゆにゅうだいりてん	輸入代理店
ゆにゅうぎょうしゃ	輸入業者
ゆにゅうきかんしゃ	輸入機関車
ゆにばーさるきばん	ユニバーサル基板
ゆそうりょくぶそく	輸送力不足
ゆそうりょくたんい	輸送力単位
ゆそうようてつどう	輸送用鉄道
ゆそうほうていしき	輸送方程式
ゆそうぶんたんりつ	輸送分担率
ゆうれいにんぎょう	幽霊人形
ゆうりょくだいぎし	有力代議士
ゆうりょくせんしゅ	有力選手
ゆうりょくせいじか	有力政治家
ゆうりょうもんだい	有料問題
ゆうりょうほうそう	有料放送
ゆうりょうきぎょう	優良企業
ゆうりゃくてんのう	雄略天皇
ゆうりかんすうぞく	有理関数族
ゆうらくちょうせん	有楽町線
ゆうめいこしょてん	有名古書店
ゆうめいかんこうち	有名観光地
ゆうびんりょうきん	郵便料金
ゆうびんばんごうぼ	郵便番号簿
ゆうびんきょくまえ	郵便局前
ゆうびんきょくどめ	郵便局止め
ゆうびんきょくいん	郵便局員
ゆうどうでんりゅう	誘導電流
ゆうどうでんどうき	誘導電動機
ゆうでんぶんきょく	誘電分極
ゆうたんぽしゃさい	有担保社債
ゆうたいりょうきん	優待料金
ゆうせんてきけんり	優先的権利
ゆうせんじょうけん	優先条件
ゆうせんじゅんじょ	優先順序
ゆうせんこうにゅう	優先購入
ゆうせいせいしょく	有性生殖
ゆうせいしょうれい	郵政省令
ゆうじんれんちゅう	友人連中
ゆうじょうかんけい	友情関係
ゆうしょくじんしゅ	有色人種
ゆうしょくざつおん	有色雑音
ゆうしょうれっぱい	優勝劣敗
ゆうしょうふかのう	優勝不可能
ゆうしょうとうしゅ	優勝投手
ゆうしょうせんせん	優勝戦線
ゆうしょうしゅうり	有償修理
ゆうしょうけってい	優勝決定
ゆうしょうけいやく	有償契約
ゆうしょうけいけん	優勝経験
ゆうしょうかくりつ	優勝確率
ゆうしょうかいすう	優勝回数
ゆうしゅうろくおん	優秀録音
ゆうしゅうさくひん	優秀作品
ゆうさんかいきゅう	有産階級
ゆうごうがたげんご	融合型言語
ゆうこうりようほう	有効利用法
ゆうこうじょうやく	友好条約
ゆうこうじかんたい	有効時間帯
ゆうこうしゅうごう	有向集合
ゆうこうしつりょう	有効質量
ゆうこうこくどうし	友好国同士
ゆうこうくかんない	有効区間内
ゆうこうきげんない	有効期限内
ゆうこうきかんない	有効期間内
ゆうげんようそほう	有限要素法
ゆうげんじょうたい	有限状態
ゆうげんしゅうごう	有限集合
ゆうげんしつりょう	有限質量
ゆうけいぶんかざい	有形文化財
ゆうきゅうきゅうか	有給休暇
ゆうきてきかんれん	有機的関連
ゆうきせいおんがく	誘起性音楽
ゆうがたしゅっぱつ	夕方出発
ゆうがいしがいせん	有害紫外線
ゆういせいけんてい	優位性検定	有意性検定
ゆあつけんしゅつき	油圧検出器
やまもがしもくぐん	ヤマモガシ目群
やまほこじゅんこう	山鉾巡行
やまはいぎんじょう	山廃吟醸
やまのうちせいやく	山之内製薬
やまのうえのおくら	山上憶良
やまなしこうじょう	山梨工場
やまたねしょうけん	山種証券
やまたねさんぎょう	山種産業
やまたけはねうぇる	山武ハネウェル
やましなじゅうみん	山科住民
やまいちしょうけん	山一證券
やちんしゅうにゅう	家賃収入
やさかにのまがたま	八尺瓊勾玉
やこうちょうきょり	夜行長距離
やくぶつりょうほう	薬物療法
やくぶつちゅうどく	薬物中毒
やくひんじょうほう	薬品情報
やくざいしめんきょ	薬剤師免許
やくがいきょういく	薬害教育
やぎゅうじゅうべえ	柳生十兵衛
やきゅうちゅうけい	野球中継
やきゅうじっきょう	野球実況
やきゅうしょうねん	野球少年
やきゅうきょうやく	野球協約
やきゅうきゅうだん	野球球団
やきはたのうぎょう	焼畑農業
やきにくていしょく	焼肉定食
やがみだいこうしゃ	矢上台校舎
やかんだいがくいん	夜間大学院
やかんざせきしよう	夜間座席使用
やかんきゅうきゅう	夜間救急
よんだいしゅうきょう	四大宗教
よよぎきょうぎじょう	代々木競技場
よやくとういつきかく	予約統一規格
よやくでんわばんごう	予約電話番号
よやくしょうめいしょ	予約証明書
よやくうけつけちゅう	予約受付中
よみうりしんぶんしゃ	読売新聞社
よみうりきょじんぐん	読売巨人軍
よなごじどうしゃどう	米子自動車道
よどはつじゅんきゅう	淀発準急
よそうもんだいしゅう	予想問題集
よせんめんじょしかく	予選免除資格
よしゆきじゅんのすけ	吉行淳之介
よこはまにしぐちこう	横浜西口校
よこはまたいようせん	横浜大洋戦
よこはませんじょうげ	横浜線上下
よこはませんかいそく	横浜線快速
よこはませいさくしょ	横浜製作所
よこはましこうほくく	横浜市港北区
よこはまきゅうじょう	横浜球場
よこはまえきにしぐち	横浜駅西口
よこはまいちりつだい	横浜市立大
よこかいてんほうしき	横回転方式
ようりょうかへんけい	容量可変型
ようめいしゅせいぞう	養命酒製造
ようびしていうんてん	曜日指定運転
ようしょせんもんてん	洋書専門店
ようしきけしょうしつ	洋式化粧室
ようしえんぐみとどけ	養子縁組届
ようげんしゅうしけい	用言終止形
ようきゅうすいじゅん	要求水準
ようきゅうじょうけん	要求条件
ようきゅうしようしょ	要求仕様書
ゆまくけいせいりょく	油膜形成力
ゆにゅうしんこくしょ	輸入申告書
ゆしゅつしんこくしょ	輸出申告書
ゆうりょうとっきゅう	有料特急
ゆうりょうきゅうこう	有料急行
ゆうらくちょうせいぶ	有楽町西武
ゆうめいしんがっこう	有名進学校
ゆうほうどうしょてん	友朋堂書店
ゆうどうほうしゃのう	誘導放射能
ゆうたいわりびきけん	優待割引券
ゆうそうてすうりょう	郵送手数料
ゆうせんでんわよやく	優先電話予約
ゆうせんじゅんいつき	優先順位付
ゆうせつすいたいさく	融雪水対策
ゆうせいかいしじこく	有声開始時刻
ゆうじんかいさつぐち	有人改札口
ゆうじょうしゅつえん	友情出演
ゆうしょうしょうひん	優勝商品	優勝賞品
ゆうしょうしょうきん	優勝賞金
ゆうしょうしゃよそう	優勝者予想
ゆうしょうきねんひん	優勝記念品
ゆうしょうきねんごう	優勝記念号
ゆうしゅうはっぴょう	優秀発表
ゆうこうきかんちゅう	有効期間中
ゆうこうかいとうすう	有効回答数
ゆうげんじっこうがた	有言実行型
ゆうけいこていしさん	有形固定資産
ゆうきすいそこうせき	有機水素鉱石
ゆーくりっどきかがく	ユークリッド幾何学
やまもとしゅうごろう	山本周五郎
やまがたしんかんせん	山形新幹線
やじうまてききょうみ	野次馬的興味
やくぶついぞんしょう	薬物依存症
やくぎょうじほうしゃ	薬業時報社
やきゅうかんけいしゃ	野球関係者
やかんちゅうきじょう	夜間駐機場
やかんすいじょうせん	夜間水上戦
よんじゅうだいぜんはん	四十代前半
よんいいじょうかくてい	四位以上確定
よどがわかせんこうえん	淀川河川公園
よていはつばいまいすう	予定発売枚数
よしはらちゅうおうえき	吉原中央駅
よしつねせんぼんざくら	義経千本桜
よこはましりつだいがく	横浜市立大学
よこはまけんきゅうじょ	横浜研究所
よくりゅうけいけんしゃ	抑留経験者
よくしゅうはっこうぶん	翌週発行分
ようぼうしょていしゅつ	要望書提出
ようそぎじゅつかいはつ	要素技術開発
ようそうろんりたいけい	様相論理体系
ようけんとうざいりょう	要検討材料
ようきゅうばらいよきん	要求払預金
ゆそうりょくぞうきょう	輸送力増強
ゆしゅつようじゅんせい	輸出用純正
ゆうりょくばじょうほう	有力馬情報
ゆうりょううんてんしゅ	優良運転手
ゆうりょううんてんしゃ	優良運転者
ゆうらくちょうえきまえ	有楽町駅前
ゆうめいてんじょうほう	有名店情報
ゆうびんふりこみようし	郵便振込用紙
ゆうびんふりかえようし	郵便振替用紙
ゆうびんふりかえこうざ	郵便振替口座
ゆうびんばんごうじしょ	郵便番号辞書
ゆうたいしゅくはくけん	優待宿泊券
ゆうせんほうそうでんわ	有線放送電話
ゆうせんしゅっそうけん	優先出走権
ゆうせいじぎょうちょう	郵政事業庁
ゆうせいかんさつきょく	郵政監察局
ゆうしょうしゅくがかい	優勝祝賀会
ゆうしょうけっていせん	優勝決定戦
ゆうしゅうきょくしょう	優秀曲賞
ゆうこうとうひょうりつ	有効投票率
ゆうこうとうひょうすう	有効投票数
ゆうこうとうひょうしゃ	有効投票者
ゆうえきせいついきゅう	有益性追求
やまがたじどうしゃどう	山形自動車道
やまかわしゅっぱんしゃ	山川出版社
やこうしんだいれっしゃ	夜行寝台列車
よみうりしんぶんゆうかん	読売新聞夕刊
よこばいかくしゅうしょく	横倍角修飾
よこはませんはしもとえき	横浜線橋本駅
よこはませんおおぐちえき	横浜線大口駅
よこはまこくりつだいがく	横浜国立大学
よこづなしんぎいいんかい	横綱審議委員会
ようりょうせっていしだい	容量設定次第
ゆにゅうばんせんもんてん	輸入盤専門店
ゆそうりょくじょうきょう	輸送力状況
ゆしゅつきょうそうりょく	輸出競争力
ゆうりょうどうろいりぐち	有料道路入口
ゆうりょうとっきゅうりつ	有料特急率
ゆうとうれっしゃせんよう	優等列車専用
ゆうとうれっしゃうんよう	優等列車運用
ゆうせいしょうすいしょう	郵政省推奨
ゆうしゅうせんしゅしょう	優秀選手賞
ゆうこうひょうじめんせき	有効表示面積
ゆうこうとうひょうちゅう	有効投票中
ゆうこうけたすうひょうじ	有効桁数表示
ゆうこういんじりょういき	有効印字領域
ゆうげんせきにんしゃいん	有限責任社員
ゆうげんせきにんがいしゃ	有限責任会社
やまなしながのけんざかい	山梨長野県境
やすくにじんじゃさんぱい	靖国神社参拝
よそうせんりょうとうりょう	予想線量等量
よしもとこうぎょうせいさく	吉本興業制作
よこはまたいようきゅうだん	横浜大洋球団
ゆうりょうちゅうしゃじょう	有料駐車場
ゆうこうきゅうじんばいりつ	有効求人倍率
ゆいぶつろんべんしょうほう	唯物論弁証法
やくぶつてきしゅうかんせい	薬物的習慣性
やきゅうかいまくちょくぜん	野球開幕直前
ゆうりょうかいしゅうほうしき	有料回収方式
やきゅうちゅうけいえんちょう	野球中継延長
ゆうりょうにゅうじょうしゃすう	有料入場者数
よくせいちゅうかんしんけいさいぼう	抑制中間神経細胞
