ぞ	曽	祖	沿	曾	初	添
ぜ	是
ず	事	刷	鶴	誦	讎	逗	図	Figure	好	讐	厨	頭	津	寿	付	済	圖	廚	濟	豆
じ	知	事	寺	持	茲	自	弍	辞	爾	仕	滋	兒	餌	史	路	亊	子	嗣	似	膩	焦	尓	字	仁	瓷	磁	蒔	恃	死	痔	迩	珥	塒	地	以	爺	峙	慈	而	邇	祀	二	司	粫	辭	寿	次	示	轜	耳	孳	侍	畤	只	璽	冶	児	至	怩	時	染	士	除	岻	治
ざ	戯	座	差	蔵	坐	藏	挫	左
ぞん	存	損
ぞろ	揃
ぞら	空
ぞめ	初め
ぞの	薗
ぞこ	底
ぞく	族	屬	属	續	束	粟	続	賊	足	俗
ぞえ	添
ぞう	雑	臧	象	臟	襍	賍	蔵	曽	像	造	三	曾	梍	藏	噌	慥	憎	臓	贈	増	贓	僧	雜
ぜん	漸	前	禪	繕	蠕	禅	喘	苒	蝉	然	譱	嶄	膳	善	髯	千	全	冉
ぜろ	〇	零
ぜめ	攻め
ぜみ	蝉
ぜひ	是非
ぜに	銭	錢
ぜつ	説	絶	舌
ぜっ	絶
ぜた	zetta
ぜぜ	膳所
ぜき	関	關
ぜい	筮	贅	税	説	噬	勢	脆
ずる	狡
ずり	刷
ずめ	詰
ずみ	済み	済	桷	濟
ずふ	図譜
ずど	図取
ずつ	頭突
ずじ	図示
ずし	図示	逗子	厨子	寿司	鮨	呪師
ずけ	附	付
ずが	図画
ずか	図化
ずえ	図会	図絵
ずい	蕊	瑞	隧	隨	惴	蕋	随	隋	膸	蘂	髄	髓
じん	進	恁	侭	刃	靱	靭	臣	陣	刄	訊	蕁	壬	甚	盡	仞	仁	塵	潯	神	迅	荏	贐	糂	腎	仭	尽	稔	燼	尋	人
じわ	地割
じろ	字路
じる	汁
じり	尻	事理
じよ	時余	爾余
じょ	所	洳	蜍	女	敍	助	鋤	抒	徐	茹	絮	如	叙	莇	汝	舒	序	耡	恕	敘	除
じゅ	儒	壽	咒	愀	懦	讎	綬	需	珠	授	讐	竪	鷲	嬬	豎	受	襦	樹	孺	寿	就	戍	得	従	聚	呪	濡
じゃ	麝	戯	邪	者	闍	蛇
じむ	寺務	時務	事務
じみ	滋味	地味
じま	嶌	島	縞	嶋
じぼ	慈母	字母
じべ	地べ
じぶ	治部
じふ	自負	慈父
じび	耳鼻
じひ	自費	慈悲
じば	磁場	字化	地場
じは	自派
じな	地鳴
じづ	字詰
じつ	實	実	昵	日
じっ	凝	十
じち	自治
じだ	耳朶	次打
じた	自他
じそ	自訴
じず	次図	字詰
じじ	自恃	爺	時々	時事
じし	自死	示指	次子
じさ	橲	字下	時差
じご	事後	爾後	持碁
じこ	仕込	自己	事故
じげ	自解	地下	地毛
じけ	寺家
じぐ	治具
じく	忸	竺	宍	衂	字句	舳	軸	衄
じぎ	時宜	辞儀	字義	児戯
じき	次期	自記	自棄	喰	時季	自機	敷	直	磁気	時機	時期	磁器	食
じが	自我	自画
じか	磁荷	磁化	字化	直	自家	時下	耳科	時価
じう	慈雨
じい	侍医	磁位	辞彙	自慰	爺	辞意	事彙	示威	字彙	次位
じあ	次亜
ざん	懴	暫	慚	惨	竄	慙	慘	鏨	懺	嶄	斬	塹	残	参	算	殘	讒	山	巉
ざわ	澤	沢
ざれ	戯れ
ざる	笊
ざり	座利
ざら	皿
ざま	座間
ざね	実
ざつ	雑	襍	雜
ざた	沙汰
ざし	差し	座視
ざさ	坐作
ざこ	雑喉	座古	雑魚
ざけ	酒
ざき	嵜	崎
ざが	坐臥	座臥
ざか	座下	坂
ざお	竿
ざえ	才
ざう	座右
ざい	罪	戝	財	剤	劑	材	済	斉	西	才	在	座位	濟
ぞんぢ	存知
ぞんち	存知
ぞんじ	存知	存じ
ぞんい	存意
ぞろめ	ゾロ目
ぞっか	俗化
ぞくり	属吏	俗吏
ぞくむ	俗務
ぞくふ	族譜
ぞくに	俗に
ぞくと	賊徒
ぞくち	俗知	属地
ぞくせ	俗世
ぞくじ	俗耳	俗事	俗字
ぞくし	賊子	続紙
ぞくご	俗語
ぞくけ	俗気
ぞくぐ	属具
ぞくか	俗化
ぞうり	草履
ぞうよ	贈与
ぞうほ	増補
ぞうふ	臓腑
ぞうび	増備
ぞうは	増派
ぞうに	雑煮
ぞうだ	造田
ぞうす	蔵主
ぞうじ	造次	造字
ぞうし	増資
ぞうさ	造作	雑作
ぞうご	造語
ぞうげ	象牙
ぞうき	臓器	雑木	造機
ぞうか	造化	増加	増価	造花
ぞうお	憎悪
ぞうい	贈位
ぜんわ	全話	禅話
ぜんら	全裸
ぜんゆ	全癒
ぜんや	善也	前夜
ぜんみ	禅味
ぜんぷ	前夫
ぜんぶ	前部	全部	膳部
ぜんぴ	前非
ぜんび	善美
ぜんば	全馬	前場
ぜんに	禅尼
ぜんど	全土	髯奴
ぜんと	全都	前途
ぜんち	全治	全知	全地	前置
ぜんだ	膳立
ぜんそ	髯蘇
ぜんせ	前世
ぜんず	全図
ぜんじ	漸次	善事	善司
ぜんし	前肢	全紙	前史	全姿	全市	全姉	禅師
ぜんざ	前座
ぜんご	善後	前後	漸悟	善吾
ぜんこ	全戸	前古
ぜんけ	禅家
ぜんく	前駆	全区
ぜんぎ	前戯
ぜんき	前記	全期	前季	全機	前期
ぜんか	全科	前科	全課	漸化
ぜんい	前位	善意	禅位
ぜろじ	０次
ぜぷと	zepto
ぜひき	是非聞
ぜにん	是認
ぜつむ	絶無
ぜつご	絶後
ぜつぎ	舌技	絶技
ぜっけ	絶家
ぜっく	絶句
ぜっか	絶佳	舌禍
ぜせい	是正
ぜげん	女衒
ぜえた	Ζ
ぜいり	税理	税吏
ぜいむ	税務
ぜいぬ	税抜
ぜいご	贅語
ぜいこ	税込
ぜあみ	世阿弥
ずろく	図録
ずれこ	ずれ込
ずよう	図様
ずめん	図面
ずぼし	図星
ずほう	修法	図法
ずぶぬ	ずぶ濡
ずぶと	図太
ずばん	図番	図版
ずはん	図版
ずのう	図嚢	頭脳
ずどり	図取り
ずてき	図的
ずつき	頭突き
ずつう	頭痛
ずぞう	図像
ずせつ	図説
ずしょ	図書
ずしき	図式
ずざん	杜撰
ずざい	徒罪
ずさん	杜撰
ずこう	図工	図功
ずけん	図研
ずけい	◆	徒刑	図形
ずきん	頭巾
ずがら	図柄
ずがく	図学
ずがい	頭蓋
ずかん	図鑑
ずかい	図解
ずいり	図入り
ずいじ	随時
ずいき	随喜	芋茎
ずいい	随意
ずあん	図案
じんわ	人和
じんや	陣屋
じんむ	神武
じんぽ	神保
じんぼ	神保
じんぴ	人肥	じん皮	靭皮
じんば	神馬	陣場	人馬
じんど	塵土	陣取
じんと	陣取
じんち	人智	陣地	人知
じんじ	仁慈	人事	神事
じんし	尋思	人士
じんご	人語	人後
じんこ	仁子
じんく	神供	甚句
じんぎ	神器	仁義	人技
じんか	人家
じんう	腎盂
じんい	人為	人意
じわれ	地割れ
じわり	地割	地割り
じろん	時論	持論
じろう	次郎	治朗	痔瘻	二郎	子郎	耳漏	次朗	治郎	二朗
じれん	自連
じれつ	字列
じれい	自励	辞礼	事例	辞令
じるし	印
じるい	字類
じりん	字林	辞林
じりつ	自律	而立	自立
じりき	地力	自力
じらい	地雷	爾来
じよう	自養	次葉	滋養
じょや	除夜
じょひ	女卑
じょじ	叙事	助辞	女児	序次	助字
じょし	女子	序詞	序詩	女史	助詞
じょく	蓐	褥	縟	辱	溽
じょう	丈	疊	饒	蒸	条	醸	情	静	杖	嬲	茸	滌	條	嫋	乗	冗	攘	星	烝	場	貞	浄	遶	畳	譲	壤	蕘	禳	繩	靜	塲	乘	穰	躡	仗	帖	穣	生	驤	聶	讓	疉	城	拯	擾	蟐	嬢	錠	仍	襄	瀞	孃	定	諚	常	娘	壌	繞	状	剰	丞	絛	疂	淨	縄	成	上	釀	剩	盛
じょい	女医	叙位
じゆう	自由	事由
じゅん	潤	篤	旬	筍	準	准	順	楯	閏	荀	恂	遵	洵	諄	循	淳	巡	盾	凖	蓴	笋	徇	馴	詢	殉	惇	隼	醇	純
じゅわ	受話
じゅり	珠理	樹理	寿理	受理	朱里	樹里
じゅよ	授与
じゅふ	呪符	授付
じゅひ	樹皮
じゅつ	述	朮	恤	術	戌
じゅそ	呪咀	受訴	呪詛
じゅず	数珠
じゅし	儒子	樹脂	樹枝	呪師	孺子
じゅく	宿	塾	受苦	孰	熟
じゅか	樹下	儒家	樹香
じゅう	澁	戎	絨	从	縦	蹂	糅	重	充	渋	從	十	中	10	獣	縱	什	拾	揉	獸	住	澀	従	銃	狃	鞣	汁	柔
じゅい	呪医
じやく	持薬
じゃん	雀
じゃわ	爪哇
じゃり	砂利
じゃら	戯
じゃま	邪魔
じゃひ	邪飛
じゃし	邪視
じゃく	雀	鉐	惹	着	弱	搦	寂	若
じゃき	邪気	邪鬼
じもん	自問	寺門	次問	字紋
じもの	地物
じもと	地元
じもく	耳目
じめん	字面	地面
じめつ	自滅
じめい	字名	自明
じむや	事務屋
じむぶ	事務部
じむひ	事務費
じむし	地虫
じむき	事務機	事務器
じみん	自民
じみめ	地味目
じみち	地道
じまん	自慢	自漫
じまま	自儘
じまひ	仕舞い
じまく	字幕
じまえ	時前	自前
じまい	仕舞	仕舞い
じぼう	自暴
じほく	磁北
じほう	時報	次鋒
じべん	自弁
じべた	地べた
じへん	事変	時変	事變
じへい	自閉	時弊
じぶん	時分	自分
じぶつ	事物
じぶく	地幅	地覆
じふん	時分	自噴
じふく	地幅	時服	自腹	地覆
じびき	地引	字引
じびか	耳鼻科
じひび	地響
じひつ	自筆
じぱい	字牌
じばん	次版	地盤
じばら	自腹
じばく	自縛	地縛	自爆
じはん	時半	次版	事犯
じはつ	次発	自発
じはだ	地肌
じはく	自白
じはい	字牌
じのし	地伸し
じねん	自然
じねつ	地熱
じぬし	地主
じにん	辞任	自任	自認
じなん	二男	次男
じなり	地鳴り
じない	寺内	耳内
じどり	地鶏	地取り
じどう	自動	侍童	児童	耳道
じとり	地鶏
じとく	自得	自涜
じとう	寺塔	地頭	字統	自答	時祷	自党
じでん	自伝
じてん	自転	字典	辭典	次点	事典	時点	辞典
じてき	自適
じてい	時程	自邸
じづら	字面
じづめ	字詰め
じづた	地伝
じつわ	実話
じつり	実理	実利
じつも	自模
じつむ	実務
じつぼ	地坪	実母
じつぶ	実部
じつは	実は
じつに	実に
じつづ	地続
じつじ	実耳	実字
じつぎ	実技
じつう	耳痛
じつい	実委	実意
じっぽ	十歩
じっぷ	実父
じっぴ	実費	実否
じっぱ	十羽	十把
じって	十手
じっち	実地
じっし	実姉	実視	十指	実子	実施
じっこ	十個
じっき	実記	実機
じっか	実科	実家
じちん	自沈
じちょ	自著
じちく	自治区
じだん	次段	示談
じだい	地代	次代	事大	時代
じたん	時短
じたつ	示達
じたく	自宅
じたい	字体	自体	字體	辞退	事態
じぞく	持続
じぞう	地蔵
じそん	自損	自存	自尊
じそく	磁束	時速	自足
じそう	時相	次走	自走	事相	自掃
じぜん	事前	慈善	次善
じせん	自薦	自選	次戦
じせつ	時節	持説	自説	次節
じせき	事蹟	次席	自責	事績	事跡	自席	耳石
じせい	時制	時世	自制	自省	辞世	時勢	磁性	自生	自製
じずら	字面
じずめ	字詰め
じすう	時数	次数	字数
じすい	自炊
じじん	時人	自尽	自刃	自陣
じじょ	次女	自助	侍女	二女	自序	自叙
じじつ	時日	事実
じじく	耳軸
じしん	時針	自身	磁針	自信	地震	磁心
じしょ	自書	自署	璽書	字書	辞書	地所
じしゅ	字種	自首	自主
じしゃ	自社	寺社	侍者	自車	辞謝	轜車
じしつ	自室	自失	痔疾	地質
じしき	次式
じざけ	地酒
じざい	自在
じさん	自賛	自讃	持参	自参
じさつ	自殺
じさげ	字下げ
じさく	治作	自作	次作
じごろ	時頃
じごく	地獄
じごえ	地声
じごう	自業	次号	寺号
じころ	時頃
じこる	事故る
じこじ	事故時
じこし	事故死
じこご	事故後
じこく	二黒	時刻	自国
じこう	自校	時好	事項	時候	次項	耳孔	時効
じげん	時限	示現	字源	示顕	辞源	次元	事言
じけん	事件
じけつ	自決
じけい	自警	字形	字型	次兄	慈恵
じぐん	自軍
じぐち	地口
じくん	字訓	二君
じくろ	舳艫
じくや	軸屋
じくば	字配
じくじ	忸怩
じくぎ	軸木
じくう	時空
じきわ	直話
じきょ	辞去
じきふ	食封
じきに	直に
じきそ	直訴
じきさ	時期差
じきか	磁気化
じがみ	地紙	地神
じがね	地金
じがた	地固
じがく	自学
じがお	地顔
じがい	自害
じかん	耳間	耳管	次官	時間	字間
じかろ	地火炉
じかび	直火
じかに	直に
じかづ	直付
じかつ	自活
じかた	地方
じかず	字数
じかく	耳殻	寺格	痔核	時隔	自覚	字画
じかが	直書
じかい	次会	自壊	耳介	持戒	字解	自戒	磁界	次回
じおん	字音
じおう	地黄
じえん	自演
じえい	自衛	侍衛	自営
じうん	時運
じうた	地歌
じいん	寺院
じいろ	地色
じいや	爺や
じあん	事案
じあめ	地雨
じあま	字余
じあげ	地上	地上げ
じあい	地合い	慈愛	時合	自愛	地合
ざんよ	残余	殘餘
ざんむ	残務
ざんぶ	残部
ざんち	残置
ざんそ	讒訴
ざんじ	暫時
ざんし	惨死	慙死	残滓
ざんさ	残渣	残差
ざんげ	慚悔	懺悔
ざんき	慙悸	慙愧	慚愧	残機	残基
ざんい	残遺
ざれえ	戯れ絵
ざれい	座礼
ざるご	笊碁
ざらめ	粗目
ざらば	ざら場
ざゆう	座右
ざやく	坐薬	座薬
ざもと	座元
ざもち	座持ち
ざめん	座面
ざまみ	座間見
ざまし	座間市
ざはき	座掃き
ざとう	座頭
ざつわ	雑話
ざつむ	雑務
ざつじ	雑事
ざつぎ	雑技
ざつき	座付
ざっぴ	雑費
ざっぱ	雑破	雑把
ざった	雑多
ざっし	雑誌
ざっき	雑記
ざっか	雑貨
ざだん	座談
ざたく	座卓
ざぞう	座像
ざそう	座葬
ざぜん	坐禅	座禅
ざせつ	挫折
ざせき	座席
ざしょ	座所
ざしゅ	座種
ざしつ	座室
ざしき	座敷
ざざい	坐剤
ざこば	雑喉場
ざこね	雑寝	雑魚寝
ざこつ	挫骨	坐骨
ざこう	座高
ざくろ	榴	石榴	柘榴
ざくつ	座屈
ざがね	座金
ざがく	座学
ざおう	蔵王
ざいん	座員
ざいや	在野
ざいむ	財務
ざいま	在間
ざいふ	在府
ざいば	在場
ざいに	在荷
ざいつ	財津
ざいす	座椅子
ざいこ	在庫	財庫
ざいけ	在家
ざいく	細工
ざいか	罪科	財貨	在荷	罪過
ざいい	在位
ぞんめい	存命
ぞんぶん	存分
ぞんねん	存念
ぞんじあ	存じ上
ぞんがい	存外
ぞっこく	属国
ぞっこう	続稿	続行
ぞっきや	ぞっき屋
ぞっかん	続刊	俗間	属官
ぞっかい	俗界	続開	俗解
ぞくろん	俗論	続論
ぞくらく	続落
ぞくよう	俗謡	俗用
ぞくめつ	族滅
ぞくめい	属名	賊名	俗名
ぞくほう	続報
ぞくへん	続編	続篇
ぞくへい	賊兵
ぞくぶん	俗文
ぞくぶつ	俗物
ぞくはつ	続発
ぞくはく	粟帛
ぞくはい	俗輩
ぞくねん	俗念
ぞくとう	属島	続騰	続投
ぞくでん	俗伝
ぞくだん	俗談
ぞくたい	俗体
ぞくぞく	続々
ぞくせつ	俗説
ぞくせい	簇生	族生	俗姓	属性	族制	俗世
ぞくじん	俗塵	属人	俗人
ぞくしん	俗心	続伸	俗信	賊臣
ぞくしょ	俗書
ぞくしゅ	俗手
ぞくさい	続載
ぞくげん	俗諺	俗言	続弦
ぞくぐん	賊軍
ぞくがん	俗眼
ぞくがら	続柄
ぞくがく	俗学
ぞくかい	俗界	続開
ぞくおん	属音
ぞくえん	続演	俗縁
ぞくえい	続映
ぞくうけ	俗受け
ぞくあく	俗悪
ぞうわい	贈賄
ぞうりん	造林
ぞうよう	雑用
ぞうもつ	臓物	雑物
ぞうもう	増毛
ぞうむし	象虫
ぞうまえ	像前
ぞうぼく	雑木
ぞうほん	造本	蔵本
ぞうほう	増俸
ぞうへい	造幣	造兵
ぞうぶん	増分
ぞうぶつ	贓物
ぞうふく	増幅
ぞうびん	増便
ぞうばい	増倍
ぞうはん	造反	増版
ぞうはつ	増発
ぞうはい	増配
ぞうとく	蔵匿
ぞうとう	贈答
ぞうてん	像点
ぞうてい	贈呈	増訂
ぞうちく	増築
ぞうだい	増大
ぞうたん	増炭	増反
ぞうそく	増速
ぞうぜい	増税	増勢
ぞうせん	造船
ぞうせつ	造設	増設
ぞうせい	造成	増生	増勢
ぞうすい	雑炊	増水
ぞうしん	増進
ぞうしょ	蔵書
ぞうしゅ	造酒
ぞうしき	雑色
ぞうざん	造山
ぞうざい	造材
ぞうさん	増産
ぞうさな	造作無
ぞうさつ	増刷
ぞうさく	造作	増作
ぞうごん	雑言
ぞうごう	贈号
ぞうこく	増石
ぞうげん	造言	増減	雑言
ぞうけつ	増結	造血
ぞうけい	造型	造形	造詣
ぞうきん	雑巾
ぞうがん	象嵌	象眼	造龕
ぞうがく	増額
ぞうかん	増刊	増感
ぞうえん	造園	増援
ぞうえき	増益
ぞうえい	造営	造影
ぞういん	増員
ぞうあく	増悪
ぜんわん	前腕	全湾	前弯
ぜんろう	全労
ぜんれつ	全裂	前列
ぜんれき	前歴
ぜんれい	前例	全例	全霊	全零
ぜんりん	前輪	善隣	禅林
ぜんりつ	全律
ぜんらく	漸落
ぜんよく	前翼
ぜんよう	前葉	全容	善用
ぜんやく	全訳	前約	善役
ぜんもん	全問	前問	前門	禅門
ぜんもう	全毛	全盲
ぜんめん	全面	前面
ぜんめつ	全滅
ぜんめい	喘鳴
ぜんまく	善悪
ぜんまい	撥条	発条	薇	發条	全妹
ぜんぽん	善本
ぜんぽう	前方
ぜんぼう	全貌
ぜんぺん	前篇	前編	全編
ぜんぺき	前壁
ぜんぺい	全閉
ぜんべい	全米
ぜんへい	全閉
ぜんぷく	全幅
ぜんぶん	前文	全文
ぜんぶも	全部持
ぜんふつ	全仏
ぜんぴん	全品
ぜんびん	前便	全便
ぜんぱん	全般	前半
ぜんぱく	前泊	全泊
ぜんぱい	全敗	全廃
ぜんばん	全判	前版
ぜんはん	全版	前半
ぜんはい	前胚	全廃
ぜんのう	全納	全脳	全農	前納	全能
ぜんねん	前年
ぜんにん	前任	善人
ぜんにち	全日
ぜんなん	善男
ぜんどう	善導	蠕動	全道	禅堂
ぜんとう	漸騰	前頭	全島
ぜんでら	禅寺
ぜんてん	全点	前転	全天	全店
ぜんてつ	前轍
ぜんてき	全摘
ぜんてい	前庭	前提
ぜんつう	全通
ぜんちょ	前著
ぜんちし	前置詞
ぜんちく	全地区
ぜんだん	全段	前段
ぜんだま	善玉
ぜんだて	膳立て
ぜんだい	前代
ぜんたん	前端
ぜんたい	全体	全隊
ぜんぞう	漸増
ぜんそん	全村	全損
ぜんそく	全速	喘息
ぜんそう	前奏	前走	禅僧	全奏
ぜんぜん	全々	前前	前々	全然
ぜんせん	前線	全線	善戦
ぜんせつ	前説	前節
ぜんせき	全席	前席
ぜんせい	善政	前世	全勢	全盛
ぜんすう	全数
ぜんじん	全人	前人
ぜんじょ	全女
ぜんじつ	前日	全日
ぜんじく	全軸
ぜんしん	前震	前審	漸進	全身	前信	前身	前進	善心
ぜんしょ	全書	善書	全所	善処
ぜんしゅ	善趣	髯鬚
ぜんしゃ	前車	漸写	全社	前者	全車	全射
ぜんしつ	前室	禅室
ぜんざん	前残	全山
ぜんざい	善哉
ぜんさく	前作
ぜんさい	前菜
ぜんごさ	前後差
ぜんごう	全豪	前号	善業
ぜんこん	前根	善根
ぜんこく	全国
ぜんこう	善行	全校	全高	前項
ぜんげん	漸減	善言	前言
ぜんげつ	前月
ぜんけん	前件	全県	全権
ぜんけい	前傾	全形	全系	前景	全景	前掲
ぜんぐん	前群	全郡	全軍
ぜんくつ	前屈
ぜんぎん	全銀
ぜんきん	前金	漸近
ぜんきひ	前期比
ぜんきち	善吉
ぜんきじ	全記事	前記事
ぜんがく	前額	全学	全額	禅学
ぜんかん	全巻	前官	前漢	前巻	善感	全館	全艦
ぜんかし	全歌詞
ぜんかく	前核	全角
ぜんかい	全解	全会	全階	全回	全快	前回	全潰	全壊	全開
ぜんおん	全音
ぜんおう	全欧
ぜんえん	前縁	全縁
ぜんえき	全駅
ぜんえい	前衛	全英
ぜんいん	全員
ぜんいつ	全一
ぜんいち	善一
ぜんいき	全域
ぜんあつ	前圧
ぜんあく	善悪
ぜろてん	零点	ゼロ点
ぜろせん	零戦
ぜろさい	ゼロ歳
ぜろげん	零元
ぜみしつ	ゼミ室
ぜひよく	是非欲
ぜひとも	是非とも
ぜひぜひ	是非是非
ぜにばこ	銭箱	銭函
ぜにごけ	銭苔
ぜにがめ	銭亀
ぜにがた	銭形
ぜにかね	銭金
ぜつりん	絶倫
ぜつめつ	絶滅
ぜつめい	絶命
ぜつぼう	絶望
ぜつだい	絶大	舌代
ぜつげん	絶絃	絶弦
ぜつがん	舌癌
ぜつおん	舌音
ぜつえん	絶遠	絶縁
ぜついん	舌咽
ぜついき	絶域
ぜっぽう	舌鋒
ぜっぺき	絶壁
ぜっぴん	絶品
ぜっぴつ	絶筆
ぜっぱん	絶版
ぜっとう	絶島	絶倒	舌頭
ぜったん	舌端
ぜったい	舌苔	絶対	絶体
ぜっそく	絶息
ぜっせん	舌戦
ぜっせい	絶世
ぜっさん	絶賛	絶讃	絶讚
ぜっこん	舌根
ぜっこつ	舌骨
ぜっこう	絶好	絶交
ぜっけい	絶景
ぜっかい	絶海
ぜぜひひ	是是非非	是々非々
ぜぜこう	膳所高
ぜいりつ	税率
ぜいりし	税理士
ぜいほう	税法
ぜいべつ	税別
ぜいぶつ	贅物
ぜいぬき	税抜き	税抜
ぜいにく	ぜい肉	贅肉
ぜいちく	筮竹
ぜいたく	贅沢
ぜいせい	脆性	税制
ぜいこみ	税込	税込み
ぜいげん	税源	贅言
ぜいきん	税金
ぜいがく	税額
ぜいかん	税関
ずんどう	寸胴
ずりょう	受領
ずぶねり	頭捻り
ずぶぬれ	ずぶ濡れ
ずひょう	図表
ずのうは	頭脳派
ずちゅう	図中
ずじょう	図上	頭上
ずじゅう	頭重
ずしきか	図式化
ずけらん	瑞慶覧
ずうたい	図体
ずうずう	図々
ずいむし	螟虫
ずいまく	髄膜
ずいぶん	隨分	随分
ずいひつ	隨筆	随筆
ずいはん	随伴
ずいのう	髄脳
ずいどう	隧道
ずいだい	隋代
ずいそう	随想
ずいせつ	瑞雪
ずいしょ	随所	隋書	隨處
ずいこう	瑞光	随行
ずいかん	随感
ずいかく	瑞鶴
ずいおう	瑞応
ずいえん	随縁	隋圜
ずいえき	髄液
ずいうん	瑞運	瑞雲
ずいいん	随員
ずいいち	随一
じんろく	甚六
じんろう	塵労
じんれつ	陣列
じんるい	人類
じんりん	人倫
じんりき	人力	尽力
じんらい	迅雷	人籟
じんよう	陣容
じんもん	尋問	訊問	陣門
じんもう	人毛
じんめん	人面
じんめい	神明	人命	神名	人名
じんみん	人民
じんまく	陣幕
じんぼつ	陣没
じんぼう	神保	人望
じんぺい	甚平	仁平
じんべえ	甚兵衛
じんぷん	人糞
じんぷく	尋腹
じんぷう	陣風	仁風
じんぶん	人文
じんぶつ	人物
じんぴん	人品
じんぱち	甚八
じんぱい	塵肺
じんにく	人肉
じんなん	神南
じんない	陣内
じんどう	仁道	人道
じんとり	神取	陣取	陣取り
じんとく	人徳	仁徳	仁篤
じんとう	人頭	陣頭
じんてん	人天
じんてき	人的
じんてい	人定
じんつう	陣痛
じんちく	人畜
じんだい	神代	甚大
じんたん	仁丹
じんたい	人体	靭帯	靱帯
じんぞう	人造	腎臓
じんそく	迅速
じんぜん	荏苒	人前
じんせん	人選	仁川	仁山
じんせき	神石	人跡
じんせい	仁政	人生	人世
じんすけ	甚介
じんじょ	仁恕
じんじゅ	人寿
じんじゃ	神社
じんじぶ	人事部
じんじつ	尽日
じんじか	人事課
じんしん	人臣	壬申	人身	人心
じんしゅ	人種
じんざい	人財	人材
じんさい	人災
じんごじ	神護寺
じんこつ	人骨
じんこう	樒	人口	櫁	人皇	沈香	人工
じんけん	人件	人権	人絹
じんけつ	人傑
じんけい	陣形	仁兄	仁恵
じんぐう	神功	神宮
じんくん	人君
じんきょ	腎虚	人居
じんがさ	陣笠
じんがい	塵外	人外
じんかん	人間
じんかく	人格
じんかい	燼灰	人界	塵芥	人海	塵界
じんえん	人煙	腎炎
じんえい	陣営
じんいん	人員
じんいち	仁一	塵一
じんあい	仁愛	塵埃
じりょく	磁力	恃力
じりょう	寺領
じりゅう	時流	自流
じりやす	じり安
じりひん	じり貧	ジリ貧
じりつご	自立語
じりだか	じり高
じらいや	児雷也
じょろん	序論
じょろう	女郎
じょれつ	序列
じょれい	除霊
じょゆう	女優
じょやく	助役
じょもう	除毛
じょめい	助命	除名
じょまく	序幕	除幕
じょほう	除法	叙法
じょへん	徐変
じょぶん	序文
じょばん	序番	序盤
じょばす	女バス
じょにん	叙任
じょなん	女難
じょどう	女童
じょてい	女帝
じょつう	除痛
じょたい	女体	除隊
じょそう	除装	除草	女装	序奏	助奏	助走
じょせつ	叙説	序説	除雪
じょせき	除斥	除籍
じょせい	女性	助勢	助成	女声	女婿
じょすう	序数	助数	除数
じょすい	如水
じょじょ	序々	徐々
じょじし	叙事詩
じょしん	女真	女神
じょしゅ	助手
じょしぶ	女子部
じょしび	女子美
じょしつ	除湿
じょしい	女子医
じょざん	除算
じょさん	除算
じょさい	如才	助祭
じょごう	除号
じょこう	女工	徐行
じょげん	序言	助言
じょけん	女権
じょけつ	女傑
じょけい	女系	叙景
じょくん	叙勲
じょくふ	褥婦
じょくち	辱知
じょくせ	濁世
じょきん	助勤	除菌
じょきょ	除去
じょがい	除外
じょかん	女官
じょかく	除核
じょかい	叙階
じょおう	女王
じょえん	助演
じょうわ	貞和	情話
じょうろ	如雨露
じょうり	条里	常理	情理	杖履	条理
じょうよ	譲与	丈余	剰余	剩餘
じょうや	常夜
じょうむ	乗務	常務
じょうみ	情味
じょうほ	譲歩
じょうぶ	丈夫	上部
じょうふ	情夫	上布	丈夫	情婦
じょうび	常備
じょうひ	上皮	冗費
じょうば	乗馬
じょうの	上の
じょうど	浄土
じょうと	譲渡
じょうち	常置	上地	上知	情痴	上智	情致	城地
じょうそ	上訴
じょうず	上手	上図
じょうじ	条二	情事	丈二	丈治	譲二	丈嗣	常児	畳字	常時	貞治
じょうし	上司	情死	上士	情シ	上肢	上使	上梓	城市	城址	情子
じょうざ	常座	上座
じょうさ	状差
じょうご	畳語	上戸	漏斗
じょうこ	杖鼓	上古
じょうげ	上下
じょうく	冗句
じょうぎ	定規	情義
じょうき	条規	情機	常規	蒸氣	上記	蒸気	常軌	上気
じょうか	浄火	情火	情科	城下	上下	浄化
じょうえ	浄衣
じょうい	攘夷	上位	情意	上衣	譲位	上意
じょいん	女陰
じゆうば	自由場
じゆうは	自由派	自由波
じゆうど	自由度
じゆうし	自由市	自由詩
じゆうか	自由化
じゅんろ	順路
じゅんり	純利	純理
じゅんら	巡邏
じゅんよ	旬余
じゅんや	純也	順彌	潤哉	潤也
じゅんめ	巡目	順目
じゅんび	順備	準備
じゅんな	純名
じゅんど	純度
じゅんて	順手
じゅんち	馴致
じゅんじ	純司	順治	順二	淳二	純二	純次	順次	純治	洵二	淳司	順司	淳嗣
じゅんし	潤史	巡視	殉死	荀子
じゅんさ	巡査
じゅんこ	準子	順子	純乎	絢子	惇子	醇乎	淳子	潤子	ＪＵＮＫＯ	純子
じゅんぐ	順繰
じゅんか	醇化	純化	順化	馴化
じゅんい	準位	遵依	准尉	順位	準尉
じゅわき	受話器
じゅろう	入牢
じゅれい	樹齢	樹苓	寿齢
じゅりん	樹林
じゅりつ	樹立
じゅりき	受理機
じゅらく	入洛	聚楽
じゅらい	入来
じゅよう	受容	需要
じゅもん	呪文
じゅもく	樹木
じゅめい	受命
じゅほう	呪法
じゅへい	寿平
じゅぶつ	呪物
じゅふん	受粉
じゅふく	寿福
じゅばん	襦袢
じゅばく	呪縛
じゅはい	受配
じゅのう	受納
じゅにく	受肉
じゅなん	受難
じゅどう	受動
じゅつぶ	述部
じゅつし	術師
じゅつご	述語	術語	術後
じゅっぽ	十歩
じゅっぱ	十把	十羽
じゅって	十手
じゅっこ	十個
じゅだく	受諾
じゅだい	入内
じゅたく	受託
じゅたい	受胎
じゅぞう	受像	受贈
じゅぜん	受禅
じゅせん	受洗
じゅせい	樹勢	受精	授精
じゅすい	入水
じゅじゅ	受授	授受
じゅしん	受診	受信	受身
じゅしょ	儒書
じゅしゅ	樹種
じゅしゃ	儒者
じゅさん	授産
じゅさつ	呪殺
じゅごん	呪禁	儒艮
じゅこん	樹根
じゅこう	受光	珠光	受講
じゅげん	呪言
じゅげむ	寿限無
じゅけん	授権	受検	受験
じゅけい	受刑
じゅくん	受勲
じゅくち	熟知
じゅくじ	熟字
じゅくし	熟視	熟思	熟柿
じゅくご	熟語
じゅくぎ	熟議
じゅがく	儒学
じゅかん	樹冠	樹幹
じゅかい	樹海	授戒	受戒
じゅおん	受音
じゅえき	樹液	受益
じゅえい	樹影
じゅうり	重利
じゅうゆ	重油
じゅうぶ	十分
じゅうひ	獣皮	柔皮
じゅうに	十二	１２
じゅうど	重度
じゅうじ	住持	十時	十字	10時	従事
じゅうし	重視	従姉	従祀	獣脂
じゅうざ	銃座
じゅうご	十五	銃後
じゅうく	重苦
じゅうき	銃器	什器	住基	重機	重器
じゅうか	重科	銃火	従価	住家
じゅうい	重囲	十位	獣医
じゅいん	樹陰
じゅいち	寿一
じゅあん	樹庵	寿庵
じゅあつ	受圧
じゃんし	雀師	雀士
じゃんき	雀鬼
じゃれん	邪恋
じゃらい	射礼
じゃよく	邪欲
じゃほう	邪法
じゃばら	蛇腹
じゃはな	謝花
じゃのめ	蛇の目
じゃねん	邪念
じゃどう	邪道
じゃっく	惹句
じゃっき	惹起
じゃっか	弱化
じゃそく	蛇足
じゃせつ	邪説
じゃせい	邪正
じゃすい	邪推
じゃしん	邪心	蛇身	邪神
じゃこう	麝香
じゃけん	邪見	邪慳	邪険	邪剣
じゃぐち	蛇口
じゃくら	雀羅
じゃくし	弱志	弱視	杓子
じゃかん	蛇管
じゃいん	邪淫
じゃあく	邪悪
じもよう	地模様
じもとし	地元紙
じもくじ	甚目寺
じむよう	事務用
じむとう	事務棟
じむてき	事務的
じむしょ	事務所
じむしつ	事務室
じむけい	事務系
じむかん	事務官
じむかた	事務方
じむいん	事務員
じむいす	事務椅子
じまんげ	自慢気
じぼしん	地母神
じぺーじ	次頁	次ページ
じぶもん	自部門
じぶくろ	地袋
じふへん	時不変
じふぶき	地吹雪
じふしん	自負心
じびょう	持病
じびーる	地ビール
じひょう	次表	時評	恃憑	辞表
じひぶか	慈悲深
じひびき	地響き
じひつふ	自筆譜
じはんき	自販機
じねんど	次年度
じにんご	辞任後
じならし	地均し
じどうし	自動詞
じどうか	自動化
じつろく	実録
じつろう	実労
じつれん	実連
じつれき	実歴
じつれい	実例
じつよう	実用
じつやく	実役
じつもふ	自模符
じつめい	実名
じつむか	実務家
じつまい	実妹
じつぶつ	実物
じつばい	実売
じつねん	実年
じつどう	実働	実動
じつづき	地続き
じつだん	実弾
じつぞん	実存
じつぞう	実像
じつじゅ	実需
じつじく	実軸
じつざい	実在
じつげん	実現
じつげつ	日月
じつがく	実学
じつがい	実害
じつかわ	実川
じつかぶ	実株
じつかた	実方
じつおん	実音
じつえん	実演
じつえき	実益
じついん	実員	実印
じっぽう	実包	十方
じっぷん	十分
じっぴき	十匹
じっとく	拾得	十徳
じってい	実弟	実体
じっつう	十通
じったい	実体	実態
じっそん	実損
じっそく	実測
じっそう	実装	十層	実相
じっせん	実践	実線	実戦
じっせつ	実説
じっせき	実績
じっせい	実勢
じっすん	実寸
じっすう	実数
じっしん	実身	十進	１０進
じっしゅ	十種
じっしゃ	実写	実車
じっしび	実施日
じっしつ	実質
じっしご	実施後
じっさく	実作
じっさい	実際
じっこん	昵懇	入魂	実根
じっこう	実行	実効
じっけん	実見	實驗	実験	実検	実権
じっけつ	十傑
じっけい	実刑	実兄	実景
じっかん	甲乙丙丁戊己庚辛壬癸	実感	十干
じっかい	十誡	実解	十界	十階	十戒
じちろう	自治労
じちょう	次長	次丁	自嘲	自重
じちたい	自治体
じちせい	自治性	自治制
じちけん	自治権
じちかい	自治会
じだんだ	地団駄	地団太
じだらく	自堕落
じたとも	自他共
じたすく	自タスク
じそくき	自速機
じぜんち	事前値
じせんき	自戦記
じせだい	次世代
じすべり	地滑り
じじょう	自浄	２乗	治定	磁場	自乗	事情	二乗	2乗
じじゅん	次順	耳順
じじゅう	侍従	自重
じじゃく	示寂	自若
じじばば	爺婆
じじかい	次々回	次次回
じしんや	地震屋
じしんは	地震波
じしんか	自信家
じしょひ	辞書引
じしょく	辞職	辞色	自食
じしょう	次章	自傷	事象	時称	自象	自称	時鐘	時尚	自照
じしゅく	自粛
じしゅう	自修	自習	次週	時宗
じしゃく	磁石
じざかい	地境
じさぼけ	時差ボケ
じさばら	橲原
じさくは	自作派
じさいと	自サイト
じごろう	滋悟郎
じごてき	事後的
じごくず	地獄図
じごくえ	地獄絵
じこれき	事故歴
じこれい	事故例
じこりつ	事故率
じこひげ	自己卑下
じこすう	事故数
じこしん	自己新
じこしゃ	事故車
じこくご	自国語
じこうほ	次候補
じこあい	自己愛
じげんめ	時限目
じげんか	次元化
じけんぼ	事件簿
じけんご	事件後
じくもの	軸物
じくばり	字配り
じくばこ	軸箱
じくはら	軸原
じくない	軸内
じくせん	軸線
じくずれ	地崩れ
じくすう	軸数
じくさく	軸索
じくがい	軸外
じくかん	次区間	軸間	時区間
じくうけ	軸受	軸受け
じくうい	時空意
じくあし	軸足
じぎょう	事業	次行	事行
じぎゃく	自虐
じきらん	直覧
じきょく	時局	磁極	自局
じきょう	自供
じきゅう	持久	自給	時給
じきもん	直門
じきぼう	次期防
じきぶん	時期分
じきひつ	直筆
じきはず	時期外
じきとう	直答
じきでん	直伝
じきでし	直弟子
じきてき	時期的	自棄的
じきだん	直談
じきそう	直奏
じきすう	時期数
じきじき	直々
じきしょ	直書
じきしゅ	次機種
じきさん	直参
じきごと	時期毎
じきけん	磁気圏
じがめん	自画面
じがため	地固め
じがぞう	自画像
じかんめ	時間目
じかんひ	時間比
じかんさ	時間差
じかんご	時間後
じかんぎ	時間切
じかんか	時間化
じかよう	自家用
じかやき	直焼き
じかづみ	直積
じかづけ	直付け
じかだん	直談
じかたび	地下足袋
じかせん	耳下腺
じかせい	自家製
じおんじ	慈恩寺
じうたい	地謡
じいぱん	Ｇパン
じいしき	自意識
じいさん	爺さん
じいさま	爺様
じいこう	時以降
じあまり	字余り
ざんるい	残塁
ざんまい	三昧
ざんぽん	槧本	残本
ざんぼう	残亡	讒謗
ざんぺん	残片
ざんぶん	残分
ざんぶつ	残物
ざんぴん	残品
ざんぱん	残飯
ざんぱつ	斬髪
ざんぱい	惨敗
ざんばつ	斬伐
ざんねん	残年	残念
ざんにん	惨忍	残忍
ざんとう	残党
ざんてき	残敵
ざんてい	暫定
ざんだか	残高
ざんぞん	残存
ざんぞう	残象	残像
ざんそん	残存
ざんぜん	嶄然
ざんぜつ	嶄絶
ざんせつ	残雪
ざんせき	残席
ざんすう	残数
ざんしん	嶄新	斬新	残心
ざんしょ	残暑
ざんしゅ	斬首
ざんしゃ	讒者
ざんざい	斬罪
ざんさつ	斬殺	惨殺
ざんさい	斬衰	残滓
ざんごう	塹壕
ざんこん	残痕
ざんこく	残酷
ざんこう	残光
ざんげん	讒言
ざんげつ	残月
ざんけん	残件
ざんぎり	散切り
ざんきん	残金
ざんがく	残額
ざんがい	斬刈	残骸	残害
ざんかん	斬姦	残寒	斬奸
ざんかい	慚悔
ざんえい	残映
ざれごと	戯言	戯事	戯れ言
ざれうた	戯歌
ざるそば	笊蕎麦
ざりがに	蜊蛄
ざらがみ	ざら紙
ざぼうき	座箒
ざぶろう	三郎
ざぶとん	座布団	座蒲団
ざひょう	座標
ざつろく	雑録
ざつよう	雑用
ざつぼく	雑木
ざつぶん	雑文
ざつぶつ	雑物
ざつのう	雑嚢
ざつねん	雑念
ざつだん	雑談
ざつだい	雑題
ざつぜん	雑然
ざつごん	雑言
ざつぎょ	雑魚
ざつがく	雑学
ざつかぶ	雑株
ざつおん	雑音
ざつえき	雑役	雑益
ざつえい	雑詠
ざっぽう	雑報
ざっぴつ	雑筆
ざっぱく	雑駁
ざっぱい	雑俳
ざっとう	雑踏	雑沓
ざっそん	雑損
ざっそく	雑則
ざっそう	雑草
ざっしょ	雑書
ざっしゅ	雑種
ざっさん	雑纂
ざっこん	雑婚
ざっこく	雑穀
ざっこう	雑考
ざっけん	雑件
ざっきん	雑菌
ざっきょ	雑居
ざっかん	雑感
ざっかや	雑貨屋
ざちょう	座長
ざちゅう	座中
ざしょう	挫傷	座礁	坐礁
ざこうじ	座光寺
ざこうさ	座高差
ざぎょう	座業	ざ行	ザ行
ざきょう	座興
ざがしら	座頭
ざえもん	左衛門
ざいらい	在来
ざいよく	財欲
ざいもく	材木
ざいめつ	罪滅
ざいめい	罪名	在銘
ざいむぶ	財務部
ざいほう	罪報	財宝
ざいべい	在米
ざいぶつ	財物
ざいばつ	財閥
ざいはく	財帛
ざいのう	財嚢
ざいにん	在任	罪人
ざいにち	在日
ざいとう	財投
ざいてん	在天
ざいてい	在廷
ざいだん	財団
ざいたく	在宅
ざいたい	罪体
ざいぞく	在俗
ざいぜん	財前
ざいせん	在仙
ざいせき	在籍	在席	材積	罪責	罪跡
ざいせい	在世	財政
ざいしょ	在所
ざいしゃ	在社
ざいしつ	材質	在室
ざいさん	財産
ざいごう	在郷	罪業
ざいこく	在国
ざいこう	在広	在校
ざいげん	財源
ざいけい	財経	財形
ざいきん	在勤
ざいがく	在学
ざいがい	在外
ざいかん	在官	在韓
ざいかた	在方
ざいかい	財界	在会
ざいおう	在欧
ざいえき	在役
ざいえい	在英
ざいあく	罪悪
ざーさい	搾菜
ぞんじより	存じ寄り
ぞんじょう	存生
ぞっきょく	俗曲
ぞっきょう	俗境
ぞっきぼん	ぞっき本
ぞくわおん	属和音
ぞくりょう	俗了	属領	属僚
ぞくりゅう	俗流	粟粒
ぞくみょう	俗名
ぞくばなれ	俗離れ
ぞくちょう	俗調	族長
ぞくちほう	属地法
ぞくせけん	俗世間
ぞくせかい	俗世界
ぞくせいち	属性値
ぞくじょう	俗情
ぞくしょう	俗称	族称
ぞくしゅつ	続出
ぞくしゅう	俗臭	俗習
ぞくぎいん	族議員
ぞうりんち	造林地
ぞうりょく	増力
ぞうりょう	増量
ぞうりむし	草履虫
ぞうらんき	造卵器	蔵卵器
ぞうよぜい	贈与税
ぞうほばん	増補版
ぞうぶんち	増分値
ぞうふくど	増幅度
ぞうふくき	増幅器
ぞうびしゃ	増備車
ぞうびがた	増備型
ぞうひょう	雑兵
ぞうちょう	増徴	増長
ぞうせつじ	増設時
ぞうせいき	造精器	蔵精器
ぞうじるし	象印
ぞうじょう	増上
ぞうしょく	増殖
ぞうしょう	蔵相
ぞうしゅつ	造出
ぞうしゅう	贈収	増収
ぞうしがや	雑司ヶ谷
ぞうさつじ	増刷時
ぞうげしつ	象牙質
ぞうげいろ	象牙色
ぞうけいび	造形美
ぞうきょう	増強
ぞうきゅう	増給
ぞうかんし	増感紙
ぞうかれつ	増加列
ぞうかりつ	増加率
ぞうかぶん	増加分
ぞうかてき	増加的
ぜんわだい	前話題
ぜんろせん	全路線
ぜんりょく	全力
ぜんりょう	善良	全量
ぜんりゃく	全略	前略
ぜんようそ	全要素
ぜんやさい	前夜祭
ぜんめんか	全面可
ぜんぽうじ	善宝寺
ぜんぼいん	全母音
ぜんほそう	全舗装
ぜんほうい	全方位
ぜんぺーじ	前頁	全ページ	前ページ
ぜんへいじ	全閉時
ぜんぶすう	全部数
ぜんふつう	全普通
ぜんひょう	全票	全表
ぜんひてい	全否定
ぜんはんぶ	前半部
ぜんはんき	前半期
ぜんはんい	全範囲
ぜんのすけ	善之助
ぜんのーど	全ノード
ぜんねんひ	前年比
ぜんねんど	前年度
ぜんにんち	前任地
ぜんにほん	全日本
ぜんにごう	前二号
ぜんにこう	前二項
ぜんとそう	全塗装
ぜんとうぶ	前頭部
ぜんでんか	全電化
ぜんつうじ	善通寺
ぜんちょう	全町	全長	前兆
ぜんちゅう	蠕虫
ぜんだんぶ	前段部
ぜんだてん	全打点
ぜんだせき	全打席
ぜんたろう	善太郎
ぜんたいず	全体図
ぜんたいし	全体子
ぜんそうさ	全操作
ぜんそうご	全奏後	前走後
ぜんぜんよ	全然読
ぜんぜんみ	全然見
ぜんせだい	前世代
ぜんせたい	全世帯
ぜんせかい	前世界	全世界
ぜんせいは	全制覇
ぜんせいじ	全勢時	全盛時
ぜんせいき	全盛期	前世紀
ぜんじろう	善二郎	善次郎
ぜんじょう	善場	禅定	前条	禅譲
ぜんじゅん	前順
ぜんじゅつ	前述
ぜんじどう	全自動
ぜんじたい	前時代
ぜんじこく	全時刻
ぜんしろう	善四郎
ぜんしょり	全処理
ぜんしょく	前職
ぜんしょう	全焼	全称	全章	前哨	前章	前檣	全勝	∀
ぜんしゅつ	前出
ぜんしゅう	全集	禅宗	前週	膳羞	全周	全州
ぜんしゃく	前借
ぜんしあい	全試合	前試合
ぜんざんじ	前山寺
ぜんさんか	全参加
ぜんさりん	前左輪
ぜんごりん	前後輪
ぜんごへん	前後編
ぜんごどう	前後動
ぜんごじく	前後軸
ぜんごさく	善後策
ぜんごえき	前後駅
ぜんこっく	全国区
ぜんこたい	全個体
ぜんこくし	全国紙
ぜんこくく	全国区
ぜんこうほ	全候補	前候補
ぜんこうじ	善光寺
ぜんこうざ	全講座
ぜんこうき	前後期
ぜんけんぶ	前件部
ぜんけいろ	全経路
ぜんけいど	前傾度
ぜんけいじ	全掲示
ぜんくろう	善九郎
ぜんくたい	前駆体
ぜんくかん	前区間	全区間
ぜんぎろん	全議論
ぜんぎょう	前行
ぜんきんち	漸近値
ぜんきよう	前期用
ぜんきょく	全局	全曲	全極
ぜんきゅう	全休
ぜんきゃく	前脚
ぜんきばん	前期版
ぜんきしゅ	全機種
ぜんきしゃ	前期車
ぜんきがた	前期型
ぜんきかん	全期間
ぜんがめん	全画面
ぜんがっき	前学期
ぜんがくぶ	全学部
ぜんかもの	前科者
ぜんかしき	漸化式
ぜんかさん	全加算
ぜんかくき	前核期
ぜんかくか	全角化
ぜんおんぷ	全音符	全音譜
ぜんえいは	前衛派
ぜんいしき	前意識
ぜんいいん	全委員
ぜろさいじ	ゼロ歳児
ぜろきんり	ゼロ金利
ぜろいんし	零因子
ぜひさんか	是非参加
ぜひいちど	是非一度
ぜにもうけ	銭儲け
ぜにうしな	銭失
ぜにあおい	銭葵
ぜつみょう	絶妙
ぜつぼうし	絶望視
ぜつえんぶ	絶縁部
ぜっふうん	絶不運
ぜっちょう	絶頂
ぜったいよ	絶対良
ぜったいち	絶対値
ぜったいし	絶対視
ぜったいか	絶対化
ぜったいい	絶対行
ぜっしょく	絶食
ぜっしょう	絶唱	絶勝
ぜっきょう	絶叫	絶境
ぜせいそち	是正措置
ぜがひでも	是が非でも
ぜいむしょ	税務所	税務署
ぜいふたん	税負担
ぜいちょう	税調
ぜいじゃく	脆弱
ぜいしゅう	税収
ずぼんつり	ズボン吊り
ずばんごう	図番号
ずのうない	頭脳内
ずのうてき	頭脳的
ずつうやく	頭痛薬
ずだぶくろ	頭陀袋
ずぞうがく	図像学
ずしきてき	図式的
ずさくせい	図作成
ずけいもじ	図形文字
ずけいてき	図形的
ずがいこつ	頭蓋骨	頭骸骨
ずかんるい	図鑑類
ずかいしょ	図解書
ずいひつか	随筆家
ずいちょう	瑞兆
ずいせんじ	瑞泉寺
ずいじょう	髄状
ずいじゅん	随順
ずいじゅう	随従
ずいしょう	瑞祥
ずいいすじ	随意筋
ずいいきん	随意筋
じんりょく	人力	尽力
じんりゅう	神竜
じんりきき	人力機
じんめんそ	人面疽
じんめいぼ	人名簿
じんみゃく	人脈
じんましん	蕁麻疹
じんぶつが	人物画
じんふぜん	腎不全
じんばおり	陣羽織
じんにょう	人尿
じんちゅう	陣中	尽忠
じんちけん	人知研
じんだいじ	深大寺
じんだいこ	陣太鼓
じんぞうこ	人造湖
じんそくか	迅速化
じんぜんじ	秦泉寺
じんじょう	尋常
じんじゅつ	仁術
じんじけん	人事権
じんじいん	人事院
じんしょう	人証
じんしゅさ	人種差
じんごろう	甚五郎
じんごうき	塵劫記
じんこうひ	人口比
じんこうじ	人工耳
じんこうこ	人工湖
じんこうき	塵功記
じんこうか	人工化
じんけんひ	人件費
じんぐうじ	神宮寺
じんぎかん	神祇官
じんきょう	人境
じんかくか	人格化
じんかいは	塵芥破
じんうえん	腎盂炎
じんいてき	人為的
じろちょう	次郎長
じれいてき	事例的
じれいすう	事例数
じれいしき	自励式
じりゅうち	自留地
じりつてき	自律的
じりつせい	自律性	自立性
じりつしん	自立心	自律心
じらいげん	地雷原
じょろうや	女郎屋
じょれいし	除霊師
じょりょく	助力
じょりゅう	女流
じょやなべ	除夜鍋
じょみゃく	徐脈
じょひょう	除表	除票
じょのくち	序の口	序ノ口
じょにだん	序二段
じょどうし	助動詞
じょちょう	助長
じょちゅう	女中
じょそうぶ	序奏部
じょせつき	除雪機
じょせいぶ	女性部
じょせいび	女性美
じょせいと	女生徒
じょせいし	女性誌
じょせいご	女性語
じょせいき	女性器
じょせいか	女性化
じょすうし	序数詞	助数詞
じょじよう	女児用
じょじょに	徐々に
じょじょう	叙情	如上	抒情
じょじゅつ	叙述
じょしよう	女子用
じょしょく	女色
じょしょう	女将	序章
じょしゅう	女囚	徐州
じょしゃく	叙爵
じょしめい	女子名
じょしべん	女子便
じょしぷろ	女子プロ
じょしはつ	女子初
じょしつき	除湿機
じょしだい	女子大
じょしこう	女子高	女子校
じょさんぷ	助産婦
じょさんし	助産師
じょさんき	除算器
じょさいな	如才無
じょこうじ	徐行時
じょくれい	縟礼
じょくそう	辱創	褥瘡
じょきょく	序曲
じょきゅう	女給
じょきゃく	除却
じょがいば	除外馬
じょうわん	上腕
じょうろく	丈六
じょうろう	上臈
じょうれん	常連	定連
じょうれい	条例	上例	条令	常例
じょうるり	浄瑠璃
じょうりつ	乗率
じょうりく	上陸
じょうらん	擾乱	上覧
じょうらく	上洛	常楽
じょうよく	情欲
じょうよう	乗用	上陽	常用	城陽	常陽
じょうゆう	城邑
じょうやど	常宿	定宿
じょうやと	常雇
じょうやく	条約
じょうもん	城門	縄文	定紋
じょうもの	上物
じょうもく	条目
じょうもう	上毛
じょうめん	上面
じょうみん	常民
じょうまん	冗漫
じょうまえ	錠前
じょうぼう	上房
じょうほく	城北	常北
じょうほう	城堡	城宝	定法	乗法	城寳	上方	常法	情報
じょうへん	上辺	城辺	上編
じょうへき	城壁
じょうへい	城兵
じょうぶん	条文	上聞	冗文
じょうぶつ	成仏
じょうふく	浄福
じょうひん	上品
じょうばん	常磐	定盤
じょうばこ	状箱
じょうはん	畳半	上半
じょうはな	城端
じょうはつ	蒸発
じょうはく	上白	上膊
じょうのう	上納
じょうねん	情念
じょうねつ	情熱
じょうにん	常任	常人
じょうなん	城南
じょうない	城内	場内
じょうどじ	浄土寺
じょうどう	杖道	成道	情動	常道
じょうとく	常徳
じょうとう	上等	上棟	常套	上道	城東
じょうでき	上出来
じょうてん	上天
じょうてい	上帝	上底	上程
じょうつう	情通
じょうちょ	情緒
じょうだん	上段	冗談
じょうだま	上玉
じょうだい	上代	城代
じょうたん	上端
じょうたつ	上達
じょうたい	状態	上腿	常態	上体	常体	情態
じょうぞう	醸造
じょうそう	情操	情想	常総	上層	上奏
じょうぜん	定禅
じょうぜつ	饒舌
じょうせん	情宣	上船	乗船
じょうせつ	常設
じょうせき	乗積	定跡	上積	定席	上席	定石	鐘石
じょうせい	城西	情勢	状勢	上製	上清	醸成
じょうすけ	譲介
じょうすう	剰数	定数	乗数	条数	常数
じょうすい	定水	上水	浄水
じょうじん	情人	成尋	常人
じょうじょ	乗除
じょうじゅ	上寿	成就
じょうじま	城島
じょうじつ	情実
じょうしん	浄心	上新	上申	上進
じょうしょ	上書	浄書	情緒	情処
じょうしゅ	城主	情趣
じょうしゃ	乗車	浄写	盛者
じょうしつ	上質
じょうした	城下
じょうしき	常式	定式	常識	上式
じょうざん	乗算
じょうざい	常在	浄罪	杖罪	剰剤	錠剤	浄財
じょうさん	乗算	蒸散
じょうさま	上様	嬢様
じょうさし	状差し	状差
じょうさく	上策	上作
じょうさい	城西	城塞	条西	城砦
じょうごわ	情強
じょうごう	乗号
じょうこん	上根	乗根
じょうこく	上告
じょうこう	条項	情工	乗降	上向	情交	上皇
じょうげん	上弦	上限
じょうけん	条件	情研	條件
じょうけい	場景	上掲	常形	杖刑	情景	上計	常経
じょうぐう	上宮
じょうくう	上空
じょうぎざ	定規座
じょうきん	常勤
じょうがん	情願
じょうがく	上顎
じょうがい	城外	場外
じょうかん	上巻	上官	乗艦	情感
じょうかた	城方
じょうかく	城郭	城閣
じょうかい	場開	常会	上界	上階
じょうおん	常温
じょうおく	場屋
じょうおう	女王
じょうえん	情炎	上演
じょうえつ	上越	上謁
じょうえい	上映
じょううち	常打
じょういん	上院	乗員	畳韻	剰員	冗員
じょういば	上位馬
じょういち	譲一
じょういき	浄域
じょうあい	情愛	情合
じゆうれん	自由練
じゆうぶん	自由文
じゆうふく	自由服
じゆうとし	自由都市
じゆうとう	自由党
じゆうたん	自由端
じゆうせき	自由席
じゆうせい	自由性
じゆうじん	自由人
じゆうざい	自由財
じゆうこう	自由港
じゆうけん	自由権
じゆうけい	自由刑
じゆうぐん	自由群
じゆうがた	自由形
じゆうえん	自由円
じゆういし	自由意思	自由意志
じゅんれつ	順列
じゅんれき	巡歴
じゅんれい	巡礼
じゅんらん	巡覧
じゅんよう	巡洋	準用
じゅんゆう	巡遊
じゅんもう	純毛
じゅんめん	純綿
じゅんまい	純米
じゅんぽう	順法	旬報	遵法	遵奉
じゅんぼく	純朴
じゅんぺい	順平
じゅんぷう	順風
じゅんぶん	純分
じゅんびい	準備委
じゅんひぶ	順日歩
じゅんぱく	純白
じゅんぱい	潤肺	巡拝
じゅんばん	順番
じゅんのう	順応
じゅんねん	閏年
じゅんなん	殉難
じゅんなま	純生
じゅんとく	潤徳	順徳
じゅんとう	順当
じゅんてん	順天
じゅんたく	潤沢
じゅんぞう	淳三	純増
じゅんそく	準則
じゅんそう	順走
じゅんぜん	純然
じゅんせん	準線
じゅんせつ	順接
じゅんせい	準正	順清	純正	醇正
じゅんすい	純水	純粋
じゅんじょ	順序
じゅんじつ	閏日	旬日
じゅんしん	順心	純真	純心
じゅんしゅ	遵守	順守
じゅんさつ	巡察
じゅんさい	蓴菜
じゅんこく	殉国
じゅんこう	順光	巡航	純項	巡幸	巡行	順行
じゅんげつ	旬月
じゅんけん	純絹	巡見	巡検
じゅんけつ	純血	純潔	準決
じゅんけい	純系	巡警	順慶
じゅんぐん	準群
じゅんぐり	順繰り
じゅんぎん	純銀
じゅんきん	純金
じゅんきょ	準拠
じゅんきし	準棋士
じゅんかん	准看	旬刊	旬間	循環
じゅんかつ	潤滑
じゅんかい	巡回
じゅんおん	純音
じゅんおく	順送
じゅんおう	順応
じゅんえん	順縁	巡演	順延
じゅんえつ	巡閲
じゅんえき	純益	準駅
じゅんいん	準員
じゅんいつ	純一
じゅんいち	准一	遵一	潤一	淳一	順一	純一
じゅんあつ	順圧
じゅんあい	純愛
じゅわしゃ	受話者
じゅりりつ	受理率
じゅりょう	受領	授領
じゅりすう	受理数
じゅよしき	授与式
じゅようや	受容野
じゅようぶ	受容部
じゅようき	受容器
じゅようか	需要家
じゅみょう	寿命
じゅふくじ	寿福寺
じゅひょう	樹氷
じゅねーぶ	壽府
じゅにゅう	授乳
じゅつほう	術法
じゅつてき	術的
じゅつぜん	術前
じゅつしゃ	術者
じゅつしき	術式
じゅつごよ	述語呼
じゅつごぶ	述語部
じゅつかい	述懐
じゅっぷん	十分
じゅっぴき	十匹
じゅっとく	拾得
じゅっつう	十通
じゅっすう	術数
じゅっしん	10進	十進	１０進
じゅっさく	述作	術策
じゅっこう	熟考
じゅっけい	術計
じゅっかい	十誡	述懐	十階	十戒
じゅちょう	受聴
じゅちゅう	受注
じゅぞうき	受像機
じゅずだま	数珠玉
じゅじょう	樹上	樹状
じゅじゅつ	呪術
じゅしんぶ	受信部
じゅしんび	受診日
じゅしんじ	受信時
じゅしんき	受信機	受信器
じゅしょう	綬章	授賞	受章	受賞
じゅしどう	樹脂道
じゅしせい	樹脂製	樹脂性
じゅこうぶ	受光部
じゅけんび	受験日
じゅけんひ	受験費
じゅけんち	受験地
じゅくれん	熟練
じゅくりょ	熟慮
じゅくらん	熟覧
じゅくみん	熟眠
じゅくねん	熟年
じゅくない	塾内
じゅくどく	熟読
じゅくとう	塾頭
じゅくだん	熟談
じゅくたつ	熟達
じゅくせい	熟成	塾生
じゅくすい	熟睡
じゅくじょ	熟女
じゅくこう	塾高	塾講	熟考
じゅくいん	塾員
じゅぎょう	受業	授業
じゅきょう	儒教	授亨	受教
じゅきゅう	需給	受給
じゅきぶつ	受寄物
じゅきしゃ	受寄者
じゅうろく	十六
じゅうろう	十郎
じゅうれん	重連
じゅうれつ	縦列
じゅうるい	獣類
じゅうりん	蹂躪	蹂躙
じゅうらん	縦覧
じゅうらい	従来
じゅうよん	十四
じゅうよく	獣欲
じゅうよう	重要	重用	充用
じゅうやく	重訳	重役	十薬
じゅうもつ	什物
じゅうもう	絨毛	獣毛	柔毛
じゅうめん	従免	渋面
じゅうめい	十名
じゅうみん	住民
じゅうまん	充満	十万
じゅうまい	十枚	従妹
じゅうぼく	従僕
じゅうほう	重宝	重砲	什宝	銃砲
じゅうべえ	十兵衛	十平衛
じゅうへい	従兵
じゅうぶん	重文	充分	十分
じゅうぶつ	従物
じゅうふく	重複
じゅうふか	重負荷
じゅうばん	重版	十番
じゅうばつ	重罰
じゅうばこ	重箱
じゅうばい	十倍
じゅうはん	重版	従犯	重犯
じゅうはち	十八
じゅうねん	十年	十念
じゅうにん	重任	住人	十人
じゅうにし	子丑寅卯辰巳午未申酉戌亥	十二支
じゅうにく	獣肉
じゅうなん	柔軟
じゅうどう	柔道
じゅうとく	重篤
じゅうとう	充当	重盗
じゅうでん	充電
じゅうてん	充填	重点
じゅうてい	従弟	重訂
じゅうづめ	重詰め
じゅうちん	重鎮
じゅうだん	銃弾	銃彈	十段	縦断
じゅうだい	重代	重大	十大	十代
じゅうたん	絨毯	絨緞
じゅうたく	住宅
じゅうたい	紐帯	銃隊	重体	縦隊	重態	渋滞	獣帯
じゅうぞく	従属
じゅうぞう	重像	十三
じゅうそつ	従卒
じゅうそく	充足	充塞
じゅうそう	重装	銃創	縦走	重曹	重奏	十三	重層
じゅうぜん	十全	従前
じゅうぜい	重税
じゅうせん	住専	縦線
じゅうせき	重責
じゅうせい	獣性	銃声	重星
じゅうすう	十数
じゅうすい	重水
じゅうじん	獣神	獣人
じゅうじろ	十字路
じゅうじや	十字屋
じゅうじつ	充実
じゅうじか	十字架
じゅうしん	銃身	獣身	重臣	重心	住心	獣心
じゅうしょ	住所
じゅうしゃ	従者
じゅうざい	重罪
じゅうさん	十三
じゅうさつ	銃殺	重殺	重刷
じゅうごや	十五夜
じゅうごう	重合
じゅうこん	重根	重婚
じゅうこつ	獸骨
じゅうこく	縦谷	重刻
じゅうこう	銃口	重厚	重項	重工	獣行
じゅうげん	重言
じゅうげき	銃撃
じゅうけん	銃剣	重検	住建
じゅうけつ	充血
じゅうけい	従兄	従系	重慶	重刑	銃刑
じゅうぐん	従軍
じゅうきょ	住居
じゅうきち	重吉
じゅうがん	銃眼
じゅうがつ	１０月	十月	神無月
じゅうがい	獣害
じゅうかん	縦貫	獣姦	重患
じゅうかく	縦隔
じゅうかき	重火器
じゅうかい	重解
じゅうおん	重音
じゅうおく	十億
じゅうおう	十王	縦横
じゅうえん	十円	重縁
じゅうえき	獣疫
じゅういん	充員
じゅういつ	充溢
じゅういち	十一
じゅういし	獣医師
じゅうあつ	重圧
じゅいしゃ	受遺者
じゃんぱい	雀牌
じゃんたく	雀卓
じゃんそう	雀荘
じゃんごう	雀豪
じゃりゅう	邪龍
じゃりみち	砂利路	砂利道
じゃまもの	邪魔物
じゃまだて	邪魔立て
じゃまくさ	邪魔臭
じゃっこく	弱国
じゃっこう	弱行	寂光
じゃっかん	弱冠	若干
じゃじゅつ	邪術
じゃしゅう	邪宗
じゃくやく	雀躍
じゃくめつ	寂滅
じゃくまく	寂寞
じゃくはん	雀斑
じゃくはく	弱拍
じゃくはい	若輩	弱輩
じゃくねん	弱年	若年	寂然
じゃくでん	弱電
じゃくてん	弱点
じゃくてき	弱敵
じゃくたい	弱体
じゃくそつ	弱卒
じゃくしん	弱震
じゃくしゃ	弱者
じゃくさん	弱酸
じゃくおん	弱音
じゃきょう	邪教
じもとみん	地元民
じもとぜい	地元勢
じもとしゃ	地元車
じめいかい	自明解
じむれべる	事務レベル
じむぶもん	事務部門
じむてづづ	事務手続
じむづくえ	事務机
じむちょう	事務長
じむじょし	事務女子
じむじょう	事務上
じむじかん	事務次官
じむしょり	事務処理
じむしょく	事務職
じむきょく	事務局
じむかんり	事務管理
じみんとう	自民党
じまくばん	字幕版
じまくいり	字幕入り
じぼひょう	字母表
じぼうじき	自暴自棄
じほくせん	磁北線
じへんまえ	事変前
じぶんよう	自分用
じぶんたち	自分達	自分たち
じぶんかつ	時分割
じぶんあて	自分宛
じびきあみ	地引き網	地曳き網	地引網
じひょうき	字表記
じひさんか	自費参加
じばちゅう	磁場中
じばくれい	地縛霊	自縛霊
じばくてろ	自爆テロ
じばいせき	自賠責
じはんころ	時半頃
じはつてき	自発的
じはつせい	自発性
じはついし	自発意思
じはくざい	自白剤
じねんじょ	自然薯
じにんせつ	辞任説
じなんぼう	次男坊
じどうまど	自動窓
じどうふか	自動付加
じどうどあ	自動ドア
じどうてき	自動的
じどうしょ	児童書
じどうしゃ	自動車
じどうしき	自動式
じどうぎれ	自動切
じどうがた	自動型
じどうかん	児童館
じとうしょ	時祷書
じてんせつ	自転説
じてんじく	自転軸
じてんしゃ	自轉車	自転車
じてっこう	磁鉄鉱
じていすう	時定数	次定数
じつりょく	実力
じつようど	実用度
じつようき	実用機	実用期
じつようか	実用化
じつむてき	実務的
じつむしゃ	実務者
じつばりき	実馬力
じつねんぴ	実燃費
じつどうさ	実動作
じつちえん	実遅延
じつせかい	実世界
じつじょう	実状	実情
じつじかん	実時間
じつしよう	実使用
じつげんみ	実現味
じつげんど	実現度
じつげんし	実現子
じつげんか	実現化
じつぎょう	実業
じつきおく	実記憶
じつがめん	実画面
じつかどう	実稼働
じつえんか	実演家
じっぴぶん	実費分
じっちょく	実直
じっちゅう	十中
じったいは	実体波
じったいか	実体化
じっそくち	実測値
じっそくず	実測図
じっそうじ	実相寺	実装時
じっそうき	実装機
じっせきば	実績馬
じっせきち	実績値
じっせかい	実世界
じっすうぶ	実数部
じっすうち	実数値
じっしれい	実施例
じっしょう	実証	実正	十漿
じっしゅう	実習	実収
じっしじき	実施時期
じっししゃ	実施者
じっさいに	実際に
じっさいか	実際家
じっこうぶ	実行部
じっこうび	実行日
じっこうち	実効値
じっこうじ	実行時
じっこうご	実行後
じっこうい	実行委
じっけんろ	実験炉
じっけんや	実験屋
じっけんぶ	実験部
じっけんち	実験値
じっけんし	実験誌
じっけんき	実験機
じっけんか	実験可
じっきょう	実況
じっかはく	実家泊
じちんさい	地鎮祭
じちりょう	自治領
じちせいふ	自治政府
じちしょう	自治省
じちさよう	自治作用
じだいもの	時代物
じだいてき	時代的
じだいそう	時代相
じだいげき	時代劇
じだいおく	時代遅	時代後
じたくまえ	自宅前
じたくせい	自宅生
じぞくてき	持続的
じぞくせい	持続性
じぞくかん	持続感
じぞくおん	持続音
じぞうどう	地蔵堂
じそんしん	自尊心
じそうほう	自走砲
じせんよう	耳栓用
じせんしょ	自薦書
じせつがら	時節柄
じせだいき	次世代機
じせきてん	自責点
じせいふん	磁性粉
じせいたい	磁性体
じせいしん	自制心
じせいけん	自制研
じすうかん	次数間
じじょでん	自叙伝
じじょうわ	２乗和	二乗和	2乗和	自乗和
じじつてき	事実的
じじつしん	事実審
じじつこん	事実婚
じしんよち	地震予知
じしんなし	自信無
じしんどう	地震動
じしんさく	自信作
じしんげん	地震源
じしんけん	地震研
じしんけい	地震計
じしんがく	地震学
じしょもの	辞書物
じしょめい	辞書名
じしょぶん	辞書分
じしょしき	辞書式
じしょうじ	慈照寺
じしょうぎ	持将棋
じしゅばん	自主盤
じしゅてき	自主的
じしゅせい	自主性
じしゅけん	自主権
じしゃわく	自社枠
じしゃびん	自社便
じしゃない	自社内
じしゃせん	自車線
じしゃせい	自社製
じしゃくか	磁石化
じしゃかぶ	自社株
じざいてん	自在天
じさんきん	持参金
じさぶろう	治三朗
じさつよう	自殺用
じさつてん	自殺点
じさつしゃ	自殺者
じさくよう	自作用
じさくひん	自作品
じさくのう	自作農
じさくきじ	自作記事
じさいてき	次最適
じごしょり	事後処理
じごくみみ	地獄耳
じごくへん	地獄変
じごくだに	地獄谷
じごくえず	地獄絵図
じこりゅう	自己流
じこぼうし	事故防止
じこほんい	自己本位
じこほぞん	自己保存
じこべんご	自己弁護
じこふたん	自己負担
じこひはん	自己批判
じこひてい	自己否定
じこはさん	自己破産
じこはかい	自己破壊
じこはあく	自己把握
じことうじ	事故当時
じこつごう	自己都合
じこちゅう	自己中	事故中
じこそしき	自己組織
じこそがい	自己疎外
じこそうじ	自己相似
じこぜんご	事故前後
じこしほん	自己資本
じこさてい	自己査定
じこげんば	事故現場
じこけんお	自己嫌悪
じこくらん	時刻欄
じこくみん	自国民
じこくない	自国内
じこくてん	持国天
じこくせい	自国製
じこぎまん	自己欺瞞
じこぎせい	自己犠牲
じこきろく	自己記録
じこきせい	自己規制
じこかんり	自己管理
じこかいき	自己回帰
じこうしき	字光式
じこいらい	事故以来
じこいしき	自己意識
じこあんじ	自己暗示
じげんてき	次元的
じげんそう	次元窓
じげんすう	次元数
じけいれつ	時系列
じけいだん	自警団
じくりゅう	軸流
じくまわり	軸回
じくじょう	軸上
じくじゅう	軸重
じくこてい	軸固定
じくうかん	時空間
じくういち	時空位置
じぎょうぶ	事業部
じぎょうか	事業家
じぎどおり	字義通り
じきふめい	時期不明
じきてーぷ	磁気テープ
じきちゅう	時期中
じきたんい	時期単位
じきじきに	直々に
じきしげき	磁気刺激
じきこうほ	次期候補
じききろく	磁気記録
じきかいろ	磁気回路
じきあらし	磁気嵐
じがじさん	自画自賛	自画自讃
じがいしき	自我意識
じかんわり	時間割
じかんわく	時間枠
じかんろん	時間論
じかんれつ	時間列
じかんりつ	時間率
じかんまど	時間窓
じかんまち	時間待
じかんまえ	時間前
じかんべつ	時間別
じかんぶん	時間分
じかんはん	時間半
じかんない	時間内
じかんてき	時間的
じかんたい	時間帯
じかんそう	時間走
じかんせん	時間線
じかんせつ	時間説
じかんせい	時間制
じかんすう	時間数
じかんじく	時間軸
じかんごと	時間毎
じかんぎれ	時間切れ
じかんきれ	時間切れ
じかんがい	時間外
じかんおく	時間遅
じかびしき	直火式
じかしょり	自家処理
じかしゅぎ	時価主義
じかくてき	自覚的
じかくすう	字画数
じかいさく	次回作
じかいけい	磁界系
じえいたい	自衛隊
じえいさく	自衛策
じえいけん	自衛権
じえいかん	自衛官
じぇっとき	ジェット機
じいこうい	自慰行為
じいがたけ	爺ヶ岳
ざんりょう	残料	残量
ざんりゅう	残留
ざんよさん	残予算
ざんにょう	残尿
ざんどすう	残度数
ざんせつき	残雪期
ざんしょう	残照
ざんくろう	斬九郎
ざんぎょう	残業
ざんぎゃく	残虐
ざんきょう	残響
ざんきゅう	斬級
ざらめゆき	粗目雪
ざひょうち	座標値
ざとういち	座頭市
ざつぎょう	雑業
ざつぎだん	雑技団
ざつおんか	雑音下
ざっしるい	雑誌類
ざっしよう	雑誌用
ざっしょく	雑食	雑色
ざっしめい	雑誌名
ざっしべつ	雑誌別
ざっしなど	雑誌等
ざっしとう	雑誌等
ざっしだい	雑誌代
ざっししゃ	雑誌社
ざっしきじ	雑誌記事
ざっしかい	雑誌会
ざっかてん	雑貨店
ざだんかい	座談会
ざせつしゃ	挫折者
ざせつかん	挫折感
ざせきわく	座席枠
ざせきりつ	座席率
ざせきすう	座席数
ざせきしゃ	座席車
ざせきした	座席下
ざせきけん	座席券
ざせきかん	座席間
ざしきろう	座敷牢
ざこたらず	座高不足
ざくろいし	石榴石
ざおうさん	蔵王山
ざおうかん	蔵王間
ざいりょく	財力
ざいりょう	材料	在寮
ざいりゅう	在留
ざいもくや	材木屋	材木谷
ざいちょう	在庁
ざいちゅう	在中
ざいせきじ	在籍時
ざいじょう	罪状
ざいじゅう	在住
ざいしょく	在職
ざいしょう	罪証	罪障
ざいしゅく	在宿
ざいしゅう	罪囚
ざいさんく	財産区
ざいさんか	財産家
ざいこひん	在庫品
ざいぎょう	罪業
ざいきょう	在京	在郷
ざいきゅう	罪咎
ざいあくし	罪悪視
ぞんじあたり	存じ当り
ぞくりょうち	属領地
ぞくへんぐん	続編群
ぞくちしゅぎ	属地主義
ぞくせいめい	属性名
ぞくじんてき	属人的
ぞくごしゅう	俗語集
ぞうわいざい	贈賄罪
ぞうほうたい	造胞体
ぞうぶつしゅ	造物主
ぞうぶつしゃ	造物者
ぞうふくりつ	増幅率
ぞうひびょう	象皮病
ぞうばいりつ	増倍率
ぞうばいかん	増倍管
ぞうはつよう	増発用
ぞうはつぶん	増発分
ぞうどしてい	像度指定
ぞうとうひん	贈答品
ぞうていばん	増訂版
ぞうていしき	贈呈式
ぞうせんじょ	造船所
ぞうせんかい	造船界
ぞうせつよう	増設用
ぞうじょうじ	増上寺
ぞうしょすう	蔵書数
ぞうしょくろ	増殖炉
ぞうざんたい	造山帯
ぞうごりょく	造語力
ぞうけつよう	増結用
ぞうけつぶん	増結分
ぞうきんがけ	雑巾掛け
ぞうきばやし	雑木林
ぞうかんほう	増感法
ぞうかんすう	像関数
ぞうかんごう	増刊号
ぞうかりょう	増加量
ぞうかぶんや	増加分野
ぞうえいざい	造影剤
ぜんわろくが	全話録画
ぜんわくせい	全惑星
ぜんろうさい	全労災	全労済
ぜんれっしゃ	全列車
ぜんりんがわ	前輪側
ぜんりょてい	全旅程
ぜんりつせん	前立腺
ぜんようたい	前葉体
ぜんゆうれん	全遊連
ぜんゆうかい	全有界
ぜんもんどう	禅問答
ぜんめんやす	全面安
ぜんめんてき	全面的
ぜんめんだか	全面高
ぜんめんかぶ	前面下部
ぜんめいじん	前名人
ぜんめいがら	全銘柄
ぜんみんぞく	全民族
ぜんみりょく	全魅力
ぜんぽうやく	前方約
ぜんほうしき	全方式
ぜんほうこう	全方向
ぜんべいいち	全米一
ぜんへんどう	全変動
ぜんへんかん	全変換
ぜんぶんけん	全文献
ぜんぶりゃく	全部略
ぜんぶふよう	全部不要
ぜんぶはいし	全部廃止
ぜんぶざせき	前部座席
ぜんひょうひ	前表皮
ぜんぱんてき	全般的
ぜんばんぐみ	全番組
ぜんはんぶん	前半分
ぜんはんせん	前半戦
ぜんはんせい	前半生
ぜんはんしゃ	全反射
ぜんはんごろ	前半頃
ぜんはんころ	前半頃
ぜんはっせい	全発声
ぜんのうしゃ	全能者
ぜんねんぶん	前年分
ぜんねんどひ	前年度比
ぜんにんしゃ	前任者
ぜんにっぽん	全日本
ぜんにってい	全日程
ぜんにっくう	全日空
ぜんにちせい	全日制
ぜんにじょう	前二条
ぜんにじゅう	全二重
ぜんなんかん	全何巻
ぜんとむこう	前途無効
ぜんとたなん	前途多難
ぜんとくてん	全得点
ぜんとうよう	前頭葉
ぜんでんげん	全電源
ぜんてんとう	全点灯
ぜんてんこう	全天候
ぜんていしき	前提式
ぜんつうじし	善通寺市
ぜんちょさく	全著作
ぜんちきゅう	全地球
ぜんだんかい	前段階
ぜんだまきん	善玉菌
ぜんだいじん	前大臣
ぜんたんまつ	全端末
ぜんたんしゃ	全単射
ぜんたいてき	全体的
ぜんたいぞう	全体像
ぜんたいせい	全体性
ぜんたいすう	全体数
ぜんたいいし	全体意思
ぜんたいいき	全帯域
ぜんそうなみ	前走並
ぜんそうしゃ	前走者	前走車
ぜんぜんべつ	全然別
ぜんぜんだめ	全然駄目
ぜんぜんそう	前前走
ぜんぜんじつ	前々日
ぜんぜんしつ	前々室
ぜんぜんげつ	前々月
ぜんぜんかい	前前回	前々回
ぜんせんちか	全線地下
ぜんせんしゅ	全選手
ぜんせきにん	全責任
ぜんせいぶん	全成分
ぜんせいひん	全製品
ぜんせいせつ	前成説
ぜんせいせき	全成績
ぜんじんるい	全人類
ぜんじんてき	全人的
ぜんじんこう	全人口
ぜんじんいん	全人員
ぜんじょせい	全女性
ぜんじゅんい	全順位
ぜんじつらい	前日来
ぜんじっけん	前実験
ぜんじちたい	全自治体
ぜんじぎょう	全事業
ぜんしんよく	全身浴
ぜんしんてき	漸進的
ぜんしんごう	全信号
ぜんしんけい	全神経
ぜんしんがた	前進型
ぜんしょうば	全勝馬
ぜんしゅるい	全種類
ぜんしゃてき	全社的
ぜんしゃしゅ	全車種
ぜんしゃいん	全社員
ぜんしーずん	前シーズン
ぜんざじあい	前座試合
ぜんざいさん	全財産
ぜんさんかん	全三巻
ぜんさくひん	全作品
ぜんさくじょ	全削除
ぜんさぎょう	全作業
ぜんごふかく	前後不覚
ぜんごどうじ	前後同時
ぜんごどうさ	前後動作
ぜんごさゆう	前後左右
ぜんごぎゃく	前後逆
ぜんこみぞう	前古未曾有
ぜんこくみん	全国民
ぜんこくばん	全国版
ぜんこくはつ	全国初
ぜんこくてき	全国的
ぜんこくきぼ	全国規模
ぜんこくいち	全国一
ぜんこうもく	全項目
ぜんこうへん	前後編
ぜんこうはん	前後半
ぜんこうてい	全肯定	全工程	全行程
ぜんこうせつ	前後節
ぜんこうせい	前向性
ぜんこうがく	全光学
ぜんげんほう	漸減法
ぜんげつぶん	前月分
ぜんけいよう	前景用
ぜんけいさん	全計算
ぜんくうかん	全空間
ぜんきんほう	漸近法
ぜんきんてき	漸近的
ぜんきんだい	前近代
ぜんきんせん	漸近線
ぜんきんしき	漸近式
ぜんきしけん	前期試験
ぜんきかてい	前期課程
ぜんがくれん	全学連
ぜんがくてき	全学的
ぜんがくせい	全学生
ぜんがくきふ	全額寄付
ぜんかんとく	前監督
ぜんかさんき	全加算器
ぜんかくもじ	全角文字
ぜんかくてい	全確定
ぜんかくこう	前各項
ぜんかくかな	全角仮名
ぜんかいろず	全回路図
ぜんかいまで	前回迄
ぜんかいぶん	前回分
ぜんかいそう	全階層
ぜんかいいん	全会員
ぜんおんかい	全音階
ぜんおんいん	全音韻
ぜんおんいき	全音域
ぜんえいもじ	全英文字
ぜんえいてき	前衛的
ぜんうりあげ	全売上
ぜんうちゅう	全宇宙
ぜんいんぶん	全員分
ぜんいでんし	全遺伝子
ぜんいきてき	全域的
ぜろくうかん	零空間
ぜみしりょう	ゼミ資料
ぜにたかぐみ	錢高組
ぜつめつしゅ	絶滅種
ぜつぼうてき	絶望的
ぜつぼうかん	絶望感
ぜつえんたい	絶縁体
ぜつえんせい	絶縁性
ぜつえんざい	絶縁材
ぜっふちょう	絶不調
ぜっちょうき	絶頂期
ぜったいろん	絶対論
ぜったいむり	絶対無理
ぜったいまけ	絶対負
ぜったいぱす	絶対パス
ぜったいてき	絶対的
ぜったいだめ	絶対駄目
ぜったいそん	絶対損
ぜったいそし	絶対阻止
ぜったいぜん	絶対善
ぜったいすう	絶対数
ぜったいしゃ	絶対者
ぜったいしき	絶対式
ぜったいごさ	絶対誤差
ぜったいけい	絶対系
ぜったいかく	絶対格
ぜったいおん	絶対音	絶体音
ぜったいいち	絶対位置
ぜったいあく	絶対悪
ぜぜこうこう	膳所高校
ぜいたくひん	贅沢品
ぜいしゅうひ	税収比
ぜいきんるい	税金類
ぜいきんりつ	税金率
ぜいきんぶん	税金分
ずめんちょう	図面帳
ずめんかんり	図面管理
ずひょうるい	図表類
ずばんしゅう	図版集
ずてきげんご	図的言語
ずしょりょう	図書寮
ずしょのかみ	図書頭
ずしほうめん	逗子方面
ずしかいがん	逗子海岸
ずけいようそ	図形要素
ずけいはいち	図形配置
ずけいしょり	図形処理
ずいまくえん	髄膜炎
ずいほうでん	瑞鳳殿
ずいぶんまえ	随分前
ずいぶんふる	随分古
ずいそうろく	随想録
じんるいがく	人類学
じんるいあい	人類愛
じんりきしゃ	人力車	俥
じんめんいわ	人面岩
じんめいろく	人名録
じんめいよう	人名用
じんめいぐん	人名群
じんむちょう	神武朝
じんむいぜん	神武以前
じんみんへい	人民幣
じんみんふく	人民服
じんみんげん	人民元
じんみんぐん	人民軍
じんぼちょう	神保町
じんぼあきら	神保彰
じんぶんちり	人文地理
じんぶんけん	人文研
じんぶんがく	人文学
じんぶつぞう	人物像
じんぴせんい	じん皮繊維
じんばきゅう	人馬宮
じんどうてき	人道的
じんとうぜい	人頭税
じんとうしき	陣頭指揮
じんつうりき	神通力
じんつうがわ	神通川
じんちょうげ	沈丁花
じんだいもじ	神代文字
じんぞうえん	腎臓炎
じんそくせい	迅速性
じんぜんしき	人前式
じんせんぬま	神仙沼
じんせいろん	人生論
じんせいてき	人生的
じんせいかん	人生観
じんじぶもん	人事部門
じんじふせい	人事不省
じんじはいち	人事配置
じんじそうむ	人事総務
じんじこうか	人事考課
じんじがかり	人事掛
じんじいどう	人事異動
じんしんじこ	人身事故
じんしんくぎ	人身供犠
じんしゅてき	人種的
じんしゅかん	人種間
じんざぶろう	甚三郎
じんざいめん	人材面
じんこうりん	人工林
じんこうゆき	人工雪
じんこうへき	人工壁
じんこうぶつ	人工物
じんこうとう	人工島
じんこうてき	人工的
じんこうぞう	人口増
じんこうすな	人工砂
じんこうすう	人口数
じんこうしば	人工芝
じんこうけい	人工系
じんこうかん	人工感
じんこうえさ	人工餌
じんこううみ	人工海
じんけんほご	人権保護
じんぐうまえ	神宮前
じんぎすかん	成吉思汗
じんかくむし	人格無視
じんかくてき	人格的
じんかくしゃ	人格者
じんかくけん	人格権
じろうかじゃ	次郎冠者
じれいしゅう	事例集
じるこにうむ	Zr	Zirconium
じりょくせん	磁力線
じりょくけい	磁力計
じりきしゅう	自力宗
じょろうぐも	女郎蜘蛛
じょゆうやく	女優役
じょやのかね	除夜の鐘
じょまくしき	除幕式
じょばんせん	序盤戦
じょはきゅう	序破急
じょてんいん	女店員
じょたんぱく	除蛋白
じょそうざい	除草剤
じょせつしゃ	除雪車
じょせいれき	女性歴
じょせいりじ	女性理事
じょせいより	女性寄り
じょせいよう	女性用
じょせいめい	女性名
じょせいてき	女性的
じょせいたち	女性達
じょせいぞう	女性像
じょせいそう	女性層
じょせいじん	女性陣
じょせいけい	女性系
じょせいぐん	女性軍
じょせいきん	助成金
じょせいがわ	女性側
じょせいがた	女性方	女性型
じょせいかん	女性観
じょせいあて	女性宛
じょじょうふ	女丈夫
じょじょうし	叙情詩	抒情詩
じょしんもじ	女真文字
じょしりょう	女子寮
じょしゅせき	助手席
じょしゅしつ	助手室
じょしゅかい	助手会
じょしぶいん	女子部員
じょしといれ	女子トイレ
じょしせいと	女子生徒
じょさいぼう	助細胞
じょげんしゃ	助言者
じょけいてき	叙景的
じょきょほう	除去法
じょきょざい	除去材	除去剤
じょがっこう	女學校	女学校
じょがっかん	女学館
じょがくせい	女学生
じょがくえん	女学園
じょがくいん	女学院
じょかんとく	助監督
じょおうばち	女王蜂
じょおうさま	女王様
じょおうごう	女王号
じょおうあり	女王蟻
じょうわんぶ	上腕部
じょうりょく	常緑
じょうりゅう	蒸溜	上流	蒸留
じょうりゃく	上略
じょうよるい	剰余類
じょうよけい	剰余系
じょうよきん	剰余金
じょうよかち	剰余価値
じょうようじ	常用字
じょうやとう	常夜燈	常夜灯
じょうやとい	常雇い
じょうやくは	条約派
じょうもんご	縄文語
じょうむりじ	常務理事
じょうむしつ	常務室
じょうむいん	乗務員
じょうみょう	定命
じょうみゃく	静脈
じょうほうや	情報屋
じょうほうぶ	情報部
じょうほうじ	浄法寺
じょうほうし	情報紙	情報誌
じょうほうか	情報科	情報化
じょうぶくろ	状袋
じょうびやく	常備薬
じょうびぶん	常微分
じょうびぐん	常備軍
じょうひょう	上平
じょうばふく	乗馬服
じょうのうち	城之内
じょうどいん	浄土因
じょうとぞん	譲渡損
じょうとぜい	譲渡税
じょうとさき	譲渡先
じょうとくい	常得意	上得意
じょうとうく	城東区	常套句
じょうてんき	上天気
じょうてもの	上手物
じょうちょく	常直
じょうちょう	上長	冗長	情調
じょうちゅう	静注	常駐	城中
じょうちゃく	蒸着
じょうちだい	上智大
じょうちそつ	上智卒
じょうたいち	状態値
じょうたいず	状態図
じょうたいか	常態化
じょうそけん	上訴権
じょうそうぶ	上層部
じょうぜんじ	定禅寺
じょうせきか	定跡化
じょうずへた	上手下手
じょうすうち	定数値
じょうすいち	浄水池	浄水地
じょうすいご	浄水後
じょうすいき	浄水機	浄水器
じょうじょう	嫋嫋	常状	上場	情状	条条	上乗	常情	上上	上々	烝烝	擾擾	常常	穣穣	畳畳
じょうじゅん	上旬
じょうじゅつ	杖術	上述
じょうじゅう	常住
じょうしんこ	上新粉
じょうしょぶ	情処部
じょうしょく	常食
じょうしょう	丞相	常勝	上昇
じょうしゅび	上首尾
じょうしゅう	常習	常州	上州	城州
じょうしゃび	乗車日
じょうしゃじ	乗車時
じょうしつし	上質紙
じょうしきか	常識化	常識家
じょうざんき	乗算器
じょうごほう	畳語法
じょうげんち	上限値
じょうげめん	上下面
じょうげほう	上下法
じょうげどう	上下動
じょうげせん	上下線
じょうげすい	上下水
じょうげかん	上下巻
じょうけんぶ	条件部
じょうけんば	条件馬
じょうけんづ	条件付
じょうけんか	条件下
じょうきょう	情況	貞享	情教	状況	上京	常況
じょうきゅう	上級	上丘	承久
じょうきゃく	常客	上客	乗客
じょうきほん	情機本
じょうきせん	蒸気船
じょうきしき	蒸気式
じょうきげん	上喜元	上機嫌
じょうきおう	蒸氣王
じょうきあん	上記案
じょうきあて	上記宛
じょうきあつ	蒸気圧
じょうがしま	城ヶ島
じょうがさき	城ケ崎
じょうがくら	城ケ倉
じょうかまち	城下町	城下街
じょうかそう	浄化槽
じょうかけん	情科研
じょうえつし	上越市
じょうえいじ	上映時
じょういばん	上位版
じょういそう	上位層
じょういじん	上位陣
じょういしゃ	上位者
じょういこう	上位校
じょういうち	上意討ち
じゆうらっか	自由落下
じゆうぶんし	自由分子
じゆうでんし	自由電子
じゆうちょう	自由帳
じゆうちいき	自由地域
じゆうじざい	自由自在
じゆうじかん	自由時間
じゆうしゅぎ	自由主義
じゆうしげん	自由資源
じゆうさんか	自由参加
じゆうげんり	自由原理
じゆうけんり	自由権利
じゆうぎょう	自由業
じゆうきょく	自由曲
じゆうきどう	自由軌道
じゆうがおか	自由ヶ丘	自由が丘
じゆうおうぼ	自由応募
じゆういぜん	自由以前
じゆうあぐん	自由亜群
じゅんりょう	純良	順良	純量
じゅんりえき	純利益
じゅんふどう	順不同
じゅんびょう	閏秒
じゅんびしつ	準備室
じゅんびごう	準備号
じゅんびこう	準備稿
じゅんびきん	準備金
じゅんびかい	準備会
じゅんばんま	順番待
じゅんのすけ	純之介	順之介	淳之介
じゅんちょう	順調
じゅんじょだ	順序立
じゅんじょう	純情
じゅんじゅん	恂恂	順順	諄々	順々	諄諄	循循
じゅんしょく	殉職	潤色	純色
じゅんしょう	准将	順昭
じゅんしゃく	巡錫
じゅんしてい	準指定
じゅんしせん	巡視船
じゅんしさん	純資産
じゅんしかん	准士官
じゅんさんそ	純酸素
じゅんこうじ	巡行時
じゅんぎょう	巡業	巡行
じゅんぎゃく	順逆
じゅんきょう	殉教	順境
じゅんきゅう	準急
じゅんきっさ	純喫茶
じゅんがくし	準学士
じゅんかんき	循環器
じゅんかめい	準加盟
じゅんかつゆ	潤滑油
じゅんかいし	巡回子
じゅんおくり	順送り
じゅんおおて	準大手
じゅんいにん	準委任
じゅんいてん	順位点
じゅんいせん	順位戦
じゅんいがい	順位外
じゅろうじん	寿老人
じゅりんたい	樹林帯
じゅりつうち	受理通知
じゅらくやき	聚楽焼
じゅらくだい	聚楽第
じゅようたい	受容体
じゅようしゃ	需要者
じゅにゅうき	授乳期
じゅなんげき	受難劇
じゅどうてき	受動的
じゅどうたい	受動態
じゅつちゅう	術中
じゅつごろん	述語論
じゅっちゅう	十中	術中
じゅっかいき	十回忌
じゅちゅうび	受注日
じゅだくしょ	受諾書
じゅたくしゃ	受託者
じゅたいりつ	受胎率
じゅせいりつ	授精率
じゅせいらん	受精卵
じゅずつなぎ	数珠繋ぎ
じゅしんよう	受信用
じゅしんばこ	受信箱
じゅしんにん	受信人
じゅしんとも	受信共
じゅしんてん	受信点
じゅしんたん	受信端
じゅしんそし	受信素子
じゅしんしゃ	受信者
じゅしんさき	受信先
じゅしんがわ	受信側
じゅこうめん	受光面
じゅこうそし	受光素子
じゅこうせい	受講生
じゅこうしゃ	受講者
じゅけんよう	受験用
じゅけんまえ	受験前
じゅけんせい	受験生
じゅけんしゃ	受験者	受検者
じゅけんしつ	受験室
じゅけんこう	受験校
じゅけつしゃ	受血者
じゅけいしゃ	受刑者
じゅくれんど	熟練度
じゅくれんち	熟練値
じゅくたつか	熟達化
じゅくせいど	熟成度
じゅくじくん	熟字訓
じゅくこうし	塾講師
じゅおんてん	受音点
じゅおんけい	受音系
じゅおんがわ	受音側
じゅおんいち	受音位置
じゅえきしゃ	受益者
じゅえきけん	受益権
じゅうろくや	十六夜
じゅうろうた	十郎太
じゅうりょく	重力
じゅうりょう	銃猟	十両	重量	従量
じゅうらいひ	従来比
じゅうらいき	従来機
じゅうような	重要な
じゅうようど	重要度
じゅうようし	重要視	重陽子
じゅうようご	重要語
じゅうもんじ	十文字
じゅうみんか	住民課
じゅうまんぶ	十万部
じゅうぼいん	重母音
じゅうべんか	重弁花
じゅうびょう	重病
じゅうばこよ	重箱読
じゅうねんめ	十年目
じゅうねんご	十年後
じゅうにりつ	十二律
じゅうにぶん	十二分
じゅうにひき	十二匹
じゅうにてん	十二天
じゅうにしと	十二使徒
じゅうにがつ	極月	十二月	師走	１２月
じゅうにおく	十二億
じゅうなんか	柔軟化
じゅうどうぶ	柔道部
じゅうどうぎ	柔道着
じゅうどうか	柔道家
じゅうでんち	充電池
じゅうでんじ	充電時
じゅうでんご	充電後
じゅうでんき	充電器	充電機
じゅうてんか	重点化
じゅうたくひ	住宅費
じゅうたくち	住宅地
じゅうたくか	住宅化
じゅうたいろ	渋滞路
じゅうたいじ	渋滞時
じゅうぞくし	従属子
じゅうそしき	柔組織
じゅうそうび	重装備
じゅうぜんじ	十禅師
じゅうせんし	重戦士
じゅうすうこ	十数戸
じゅうすいろ	重水炉
じゅうすいそ	重水素
じゅうじょう	十条	重畳
じゅうじゅん	従順	柔順	重巡
じゅうじゅつ	柔術
じゅうじゅう	重々
じゅうじつひ	充実費
じゅうじつど	充実度
じゅうじつき	充実期
じゅうじしゃ	従事者
じゅうじけい	十字形
じゅうじぐん	十字軍
じゅうじがた	十字固	十字形
じゅうしょち	住所地
じゅうしょく	重職	住職
じゅうしょう	重症	重唱	重傷	重賞
じゅうしゅつ	重出
じゅうしやま	十四山
じゅうしまつ	十姉妹
じゅうしまい	従姉妹
じゅうしてい	従姉弟
じゅうしちし	十七史
じゅうさんや	十三夜
じゅうごひき	十五匹
じゅうごおく	十五億
じゅうごうど	重合度
じゅうぎょう	従業
じゅうきょち	住居地
じゅうきゅう	十九
じゅうきせい	銃規制
じゅうきざい	重機材
じゅうきかい	重機械
じゅうかぜい	従価税
じゅうかしつ	重過失
じゅうかがく	重化学
じゅうかいき	重回帰
じゅうおうか	縦横家
じゅういおん	重イオン
じゃんぷだい	ジャンプ台
じゃっかんき	若干気
じゃずきっさ	ジャズ喫茶
じゃじゃうま	じゃじゃ馬
じゃこうねこ	麝香猫
じゃこうじか	麝香鹿
じゃくちょう	寂聴
じゃくちゅう	若冲
じゃくたいか	弱体化
じゃくじょう	寂静
じゃくしょう	弱小
じゃくししゃ	弱視者
じゃくおんき	弱音器
じもんじとう	自問自答
じもとゆうり	地元有利
じもとしほん	地元資本
じもとしこう	地元指向
じもといしき	地元意識
じもといがい	地元以外
じめつこうい	自滅行為
じむれんらく	事務連絡
じむようひん	事務用品
じむほさいん	事務補佐員
じむぶちょう	事務部長
じむてつづき	事務手続き
じむていいん	事務定員
じむしょるい	事務書類
じむしょがわ	事務所側
じむさぎょう	事務作業
じむけいさん	事務計算
じむききてん	事務機器展
じむかんそか	事務簡素化
じむかちょう	事務課長
じまんばなし	自慢話
じへいしょう	自閉症
じぶんりゅう	自分流
じぶんめいぎ	自分名義
じぶんほんい	自分本位
じぶんひとり	自分一人
じぶんじしん	自分自身
じぶんしだい	自分次第
じぶんごのみ	自分好み
じぶんこじん	自分個人
じぶんかって	自分勝手
じぶんいがい	自分以外
じびいんこう	耳鼻咽喉
じばんちんか	地盤沈下
じばくそうち	自爆装置
じはつこうい	自発行為
じねんほうに	自然法爾
じないちょう	寺内町
じどうろこう	自動露光
じどうろくが	自動録画
じどうよやく	自動予約
じどうまんが	児童漫画
じどうほせい	自動補正
じどうにりん	自動二輪
じどうてんぷ	自動添付
じどうていぎ	自動定義
じどうてあて	児童手当
じどうそうふ	自動送付
じどうそうさ	自動操作
じどうしょり	自動処理
じどうしゃや	自動車屋
じどうしゃぶ	自動車部
じどうざっし	児童雑誌
じどうけんさ	自動検査
じどうきどう	自動起動
じどうがほう	児童画報
じどうがっき	自動楽器
じどうかんり	自動管理
じてんそくど	自転速度
じてんしゃや	自転車屋
じてんしゃの	自転車乗
じづらじょう	字面上
じつりょくば	実力馬
じつりょくは	実力派
じつりょくさ	実力差
じつようれい	実用例
じつようめん	実用面
じつようひん	実用品
じつようてき	実用的
じつようせい	実用性
じつようしょ	実用書
じつようしゃ	実用車
じつぶつだい	実物大
じつひきすう	実引数
じつねんろん	実念論
じつねんれい	実年齢
じつていすう	実定数
じつたいけん	実体験
じつじかんか	実時間化
じつざいろん	実在論
じつざいてき	実在的
じつざいせい	実在性
じつざいかん	実在感
じつさぎょう	実作業
じつこうりつ	実効率
じつげんほう	実現法
じつげんせい	実現性
じつけいそく	実計測
じつけいすう	実係数
じつくうかん	実空間
じつぎょうか	実業家
じつぎしけん	実技試験
じつかんすう	実関数
じつかそくど	実加速度
じつおんぞう	実音像
じつおんせい	実音声
じつおんげん	実音源
じつうんよう	実運用
じっぷんかん	十分間
じっぴふたん	実費負担
じっていほう	実定法
じったいほう	実体法
じったいてき	実態的	実体的
じったいけん	実体験
じっそくれい	実測例
じっそうれい	実装例
じっそうほう	実装方	実装法
じっせんへん	実践編
じっせんてき	実戦的	実践的
じっせんけい	実戦形
じっせきさく	実績作
じっせきあり	実績有
じっせいかつ	実生活	實生活
じっすうろん	実数論
じっすうたい	実数体
じっすうがた	実数型
じっすうかい	実数解
じっしんほう	十進法
じっしんすう	十進数
じっしゃもの	実写物
じっしゃふう	実写風
じっしゃばん	実写版
じっしゃかい	実社会
じっしつやく	実質役
じっしつてき	実質的
じっしちゅう	実施中
じっさぎょう	実作業
じっさいてき	実際的
じっさいせい	実際性
じっこうれい	実行例
じっこうまえ	実行前
じっこうほう	実行法
じっこうぶん	実行文
じっこうはん	実行犯
じっこうてき	実効的
じっこうたい	実行体
じっこうせい	実効性
じっこうしゃ	実行者
じっこうけん	実行権
じっこうがた	実行型
じっけんれい	実験例
じっけんよう	実験用
じっけんとう	実験棟
じっけんてき	実験的
じっけんだい	実験台
じっけんせい	実験星
じっけんずみ	実験済
じっけんすい	実験水
じっけんしゃ	実験者
じっけんしつ	実験室
じっけんしき	実験式
じっけんごさ	実験誤差
じっけんけい	実験系
じっけんきぐ	実験器具
じちょうてき	自嘲的
じちょうたん	次頂端
じちだいじん	自治大臣
じちかいしつ	自治会室
じだいまつり	時代祭
じだいじゅん	時代順
じだいしょく	時代色
じだいしゅぎ	事大主義
じだいさくご	時代錯誤
じだいおくれ	時代後れ	時代遅れ
じたくたいき	自宅待機
じたいじょう	辞退状
じぞくりょく	持続力
じぞくじかん	持続時間
じぞくかのう	持続可能
じぞうとうげ	地蔵峠
じそんじえい	自存自衛
じそくみつど	磁束密度
じそうろんり	時相論理
じそうかのう	自走可能
じぜんよやく	事前予約
じぜんぶんぷ	事前分布
じぜんはいふ	事前配布
じぜんとうぎ	事前討議
じぜんしんさ	事前審査
じぜんしてい	事前指定
じせんたせん	自薦他薦
じせきのねん	自責の念
じずらどおり	字面通り
じすうしてい	字数指定
じじょうほう	二乗法
じじょうつう	事情通
じじょうたい	次状態
じじょうごさ	二乗誤差	2乗誤差
じじもんだい	時事問題
じじつむこん	事実無根
じじつじょう	事実上
じじつごにん	事実誤認
じじこっこく	時々刻々
じじこくこく	時々刻々
じしんほけん	地震保険
じしんちたい	地震地帯
じしんがくし	地震学史
じしょじゅん	辞書順
じしょかんり	辞書管理
じしゅけんさ	自主検査
じしゅきせい	自主規制
じしゅかんり	自主管理
じしゅうしつ	自習室
じしゃくかん	自社区間
じしゃかんぶ	自社幹部
じさつみすい	自殺未遂
じさつこうい	自殺行為
じさくじゅつ	自作術
じさくじえん	自作自演
じさくきょく	自作曲
じごれんらく	事後連絡
じごほうこく	事後報告
じごごうとう	事後強盗
じごうよこく	次号予告
じごうじとく	自業自得
じこよくせい	自己抑制
じこむじゅん	自己矛盾
じこまんぞく	自己満足
じこぼうぎょ	自己防御
じこぼうえい	自己防衛
じこほうこく	事故報告
じこべんかい	自己弁解
じこぶんせき	自己分析
じこひょうか	自己評価
じこばいばい	自己売買
じこはんせい	自己反省
じこはんえい	自己反映
じこはっせい	事故発生
じこにんしき	自己認識
じこないよう	事故内容
じこどうけい	自己同型
じことうえい	自己投影
じこてきよう	自己適用
じこていせい	自己訂正
じこちょくご	事故直後
じこちょうさ	自己調査	事故調査
じこそしきか	自己組織化
じこそうぞう	自己創造
じこそうかん	自己相関
じこせきにん	事故責任	自己責任
じこじつげん	自己実現
じこしんだん	自己診断
じこしんせい	自己申請
じこしんこく	自己申告
じこしんこう	自己進行
じこしゃへい	自己遮蔽
じこさいみん	自己催眠
じこさいてん	自己採点
じこさいこう	自己最高
じここうたい	自己抗体
じこけいやく	自己契約
じこけいはつ	自己啓発
じこけいたい	事故形態
じこけいせい	自己形成
じこくんれん	自己訓練
じこくりょう	自国領
じこくぶんか	自国文化
じこくひょう	時刻表
じこくこっか	自国国家
じこくいこう	時刻以降
じこきんゆう	自己金融
じこきじゅん	自己基準
じこかんけつ	自己完結
じこかぶしき	自己株式
じこかいとう	自己解凍
じこかいぞう	自己改造
じこかいけつ	自己解決
じこかいかく	自己改革
じこうほぐん	次候補群
じこうきかん	時効期間
じげんりゅう	示現流
じげんそうち	時限装置
じげんじょう	次元上
じけんちょう	事件帳
じけんげんば	事件現場
じけんいらい	事件以来
じくほうこう	軸方向
じくそうかん	軸相関
じくせいぶん	軸成分
じくかいせき	字句解析
じぎょうよう	事業用
じぎょうぬし	事業主
じぎょうだん	事業団
じぎょうたい	事業体
じぎょうぜい	事業税
じぎょうしょ	事業所
じぎょうしゅ	事業主
じぎょうしゃ	事業者
じぎょうしつ	事業室
じぎょうかい	事業会
じぎゃくてき	自虐的
じきゆうどう	磁気誘導
じきゅうりつ	自給率
じきゅうそう	持久走
じきゅうせん	持久戦
じきほうそう	次期放送
じきばいたい	磁気媒体
じきだんぱん	直談判
じきしゃへい	磁気遮蔽
じきさくひん	次期作品
じきこっかい	次期国会
じきかいてい	次期改訂
じかんろんり	時間論理
じかんようそ	時間要素
じかんへんか	時間変化
じかんぶそく	時間不足
じかんびぶん	時間微分
じかんひょう	時間表
じかんはけい	時間波形
じかんていど	時間程度
じかんていし	時間停止
じかんつぶし	時間潰し
じかんちょう	時間長
じかんちゅう	時間中
じかんちかく	時間知覚
じかんちえん	時間遅延
じかんしょり	時間処理
じかんしてい	時間指定
じかんさぶん	時間差分
じかんこうか	時間効果
じかんけいか	時間経過
じかんくかん	時間区間
じかんきろく	時間記録
じかんきゅう	時間休	時間給
じかんかへん	時間可変
じかんおくれ	時間遅れ
じかんいない	時間以内
じかんいぞん	時間依存
じかんいがい	時間以外
じかようしゃ	自家用車
じかはつでん	自家発電
じかはっこう	時価発行
じかだんぱん	直談判
じかそうがく	時価総額
じかせんえん	耳下腺炎
じかせいみそ	自家製味噌
じかせいさん	自家製産
じかじゅふん	自家受粉
じかじゅせい	自花受精	自家受精
じかしょうひ	自家消費
じかさいばい	自家栽培
じかげんぞう	自家現像
じかくしだい	自覚次第
じかかいけい	時価会計
じかいよこく	次回予告
じかいかんじ	次回幹事
じかいかいぎ	次回会議
じかいいこう	次回以降
じえいそしき	自衛組織
じえいぎょう	自営業
ざんむしょり	残務処理
ざんねんかい	残念会
ざんにっすう	残日数
ざんてつけん	斬鉄剣
ざんていばん	暫定版
ざんていてき	暫定的
ざんていそち	暫定措置
ざんていかい	暫定解
ざんていあん	暫定案
ざんだんすう	残弾数
ざんぞんりつ	残存率
ざんじつろく	残日録
ざんさぶんぷ	残差分布
ざんさぎょう	残作業
ざんきりょう	残気量
ざんあつけい	残圧計
ざゆうのめい	座右の銘
ざひょうじく	座標軸
ざひょうけい	座標系
ざとうくじら	座頭鯨
ざつみんとう	雑民党
ざつはいすい	雑排水
ざつだんふう	雑談風
ざつしょとく	雑所得
ざつさぎょう	雑作業
ざつごんこし	雑言古詩
ざつがくぼん	雑学本
ざっしたんか	雑誌単価
ざっしじょう	雑誌上
ざっきょぼう	雑居房
ざっきょびる	雑居ビル
ざっきちょう	雑記帳
ざせきよやく	座席予約
ざせきひょう	座席表
ざせきはいち	座席配置
ざせきぜんご	座席前後
ざせきしよう	座席使用
ざせきしてい	座席指定
ざせきかくほ	座席確保
ざしきわらし	座敷童
ざおうちょう	蔵王町
ざいりょうぶ	材料部
ざいりょうひ	材料費
ざいりょうし	材料視
ざいらいせん	在来線
ざいらいしゅ	在来種
ざいらいしゃ	在来車
ざいらいがた	在来型
ざいらいえき	在来駅
ざいむしょう	財務省
ざいむかんり	財務管理
ざいにっぽん	在日本
ざいつかずお	財津和夫
ざいぞくそう	在俗僧
ざいせきしゃ	在籍者
ざいせいめん	財政面
ざいせいほう	財政法
ざいせいなん	財政難
ざいせいてき	財政的
ざいせいがく	財政学
ざいさんてき	財産的
ざいさんぜい	財産税
ざいさんけん	財産権
ざいさんけい	財産刑
ざいこぶそく	在庫不足
ざいこくがい	在国外
ざいこかんり	在庫管理
ざいがくせい	在学生
ざいがくしゃ	在学者
ざいかいじん	財界人
ざいいきかん	在位期間
ざいあくかん	罪悪感
ぞんめいちゅう	存命中
ぞっこうちゅう	続行中
ぞっこうかのう	続行可能
ぞくぶつずかん	俗物図鑑
ぞくせいへんか	属性変化
ぞくさんへんど	粟散辺土
ぞうりょくざい	増力剤
ぞうへいしょう	造兵廠
ぞうへいきょく	造幣局
ぞうふくきのう	増幅機能
ぞうひょうたち	雑兵達
ぞうちょうてん	増長天
ぞうちくちゅう	増築中
ぞうだいかてい	増大過程
ぞうせつぶぶん	増設部分
ぞうせつとびら	増設扉
ぞうせつかのう	増設可能
ぞうせいちゅう	造成中
ぞうじょうまん	増上慢
ぞうじょうてん	増長天
ぞうじてんぱい	造次顛沛
ぞうしょくほう	増殖法
ぞうしゅうわい	贈収賄
ぞうげかいがん	象牙海岸
ぞうけつかのう	増結可能
ぞうけいきかく	造形企画
ぞうきかんかく	臓器感覚
ぞうきいしょく	臓器移植
ぞうかんしょり	増感処理
ぞうかけいこう	増加傾向
ぞうえんぶたい	増援部隊
ぞうえんがかり	造園係
ぜんれいていじ	前例提示
ぜんれいちゅう	全冷中
ぜんりんくどう	前輪駆動
ぜんりょうせい	全寮制
ぜんりょういき	全領域
ぜんりゅうふん	全粒粉
ぜんようりょう	全容量
ぜんめんはいし	全面廃止
ぜんめんさんか	全面参加
ぜんめんきんし	全面禁止
ぜんぽうていい	前方定位
ぜんぽうしかい	前方視界
ぜんぽうさゆう	前方左右
ぜんぽういっち	前方一致
ぜんべいじょし	全米女子
ぜんべいかくち	全米各地
ぜんべいおうざ	全米王座
ぜんへんきょく	全編曲
ぜんぶまんいん	全部満員
ぜんぶへんこう	全部変更
ぜんぶへんかん	全部変換
ぜんぶはんけつ	全部判決
ぜんぶどうれつ	全部同列
ぜんぶこうかん	全部交換
ぜんぶおおもじ	全部大文字
ぜんぶいんよう	全部引用
ぜんふんにゅう	全粉乳
ぜんふれんけつ	全不連結
ぜんぴんけんさ	全品検査
ぜんはんぶぶん	前半部分
ぜんはんさいご	前半最後
ぜんのうりょく	全能力
ぜんにちじょし	全日女子
ぜんとようよう	前途洋々
ぜんてんしゅう	全天周
ぜんていちしき	前提知識
ぜんていごうい	前提合意
ぜんちゅううら	全中裏
ぜんちぜんのう	全知全能
ぜんだいみもん	前代未聞
ぜんだいひょう	前代表
ぜんたいじゅう	全体重
ぜんたいしゅぎ	全体主義
ぜんたいかんり	全体管理
ぜんたいかいぎ	全体会議
ぜんそくりょく	全速力
ぜんそうきょく	前奏曲
ぜんぜんへいき	全然平気
ぜんぜんしゅう	前々週
ぜんせんふつう	全線不通
ぜんせんでんか	全線電化
ぜんせんきんむ	前線勤務
ぜんせんきょく	全選挙区
ぜんせきじゆう	全席自由
ぜんせきしてい	全席指定
ぜんせきこしつ	全席個室
ぜんせかいてき	全世界的
ぜんせいりょく	全勢力
ぜんせいじだい	全盛時代
ぜんじんみとう	前人未踏	全人未踏
ぜんじんかいぎ	善人会議
ぜんじゅんじょ	前順序	全順序
ぜんじゅうきょ	前住居
ぜんじだいてき	前時代的
ぜんじくくどう	全軸駆動
ぜんしんやけど	全身火傷
ぜんしんますい	全身麻酔
ぜんしんちゅう	前進中
ぜんしんだぼく	全身打撲
ぜんしんしゅび	前進守備
ぜんしんしてい	前進指定
ぜんしょちょう	前所長
ぜんしょうめい	全証明
ぜんしょうとう	前照灯
ぜんしょうせん	前哨戦
ぜんしょうきょ	全消去
ぜんしゅだいか	全主題歌
ぜんしゅしょう	前首相
ぜんしゅうろく	全収録
ぜんしゅうもの	全集物
ぜんしゅうばん	全集版
ぜんしゃりょう	全車両
ぜんしゃふべん	善者不辯	善者不弁
ぜんしゃしてい	全車指定
ぜんしつりょう	全質量
ぜんしぜんぐん	全市全郡
ぜんさんかしゃ	全参加者
ぜんさくちゅう	前作中
ぜんごほうこう	前後方向
ぜんごぶんかつ	前後分割
ぜんごひとくみ	前後一組
ぜんごはんとし	前後半年
ぜんごかんけい	前後関係
ぜんこようしゃ	全雇用者
ぜんこていえき	前固定液
ぜんこくたんい	全国単位
ぜんこくそしき	全国組織
ぜんこくせいは	全国制覇
ぜんこくかくち	全国各地
ぜんこうほぐん	前候補群
ぜんこうせいと	全校生徒
ぜんけいしょく	前景色	全景色
ぜんけいしせい	前傾姿勢
ぜんくみあわせ	全組合せ
ぜんぎんきょう	全銀協
ぜんきょくばん	全曲版
ぜんきょくとお	全曲通
ぜんきょくすう	全曲数
ぜんきょくがた	全極型
ぜんきょうとう	全共闘
ぜんきょうだい	全兄弟
ぜんきゅうだん	全球団
ぜんきにってい	前期日程
ぜんきさいだい	前期最大
ぜんがくふたん	全額負担
ぜんがくしょう	全楽章
ぜんかんりにん	前管理人
ぜんかんしよう	全館使用
ぜんかいよこく	前回予告
ぜんかいじょう	全会場
ぜんかいきどう	前回起動
ぜんかいいっち	全会一致
ぜんえきつうか	全駅通過
ぜんえいぶとう	前衛舞踏
ぜんいんぜんか	善因善果
ぜんいんさんか	全員参加
ぜんいんいっち	全員一致
ぜんいしゅとく	善意取得
ぜひしょうかい	是非紹介
ぜねらるせきゆ	ゼネラル石油
ぜにがたへいじ	銭形平次
ぜにかんじょう	銭勘定
ぜつえんじょう	絶縁状
ぜっとへんかん	Ｚ変換
ぜったいれいど	絶対零度
ぜったいりょう	絶対量
ぜったいむてき	絶対無敵
ぜったいたすう	絶対多数
ぜったいじかん	絶対時間
ぜったいしゅぎ	絶対主義
ぜったいけいご	絶対敬語
ぜったいかせき	絶対可積
ぜったいおんど	絶対温度
ぜったいうずど	絶対渦度
ぜっこうちょう	絶好調
ぜっこうきゅう	絶好球
ぜせいろんしゃ	是正論者
ぜいむちょうさ	税務調査
ぜいむだいりし	税務代理士
ぜいむじむしょ	税務事務所
ぜいほうじょう	税法上
ぜいべつかかく	税別価格
ぜいせいじょう	税制上
ぜいじゃくせい	脆弱性
ぜいしゅうぞう	税収増
ぜいしゅうげん	税収減
ぜいきんいがい	税金以外
ぜいがくひょう	税額表
ずのうろうどう	頭脳労働
ずのうめいせき	頭脳明晰
ずしょうりゃく	図省略
ずしこつぼこう	逗子小坪港
ずけいひょうじ	図形表示
ずけいひょうき	図形表記
ずけいきじゅつ	図形記述
ずかんそくねつ	頭寒足熱
ずいほうしょう	瑞宝章
ずいぶんむかし	随分昔
ずいぶんいぜん	随分以前
ずいひつしゅう	随筆集
ずいじうけつけ	随時受付
ずいいけいやく	随意契約
じんるいふへん	人類普遍
じんるいどうし	人類同士
じんめいじてん	人名辞典
じんめいじしょ	人名辞書
じんむてんのう	神武天皇
じんみんしゅぎ	人民主義
じんぽんしゅぎ	人本主義
じんぼうちょう	神保町
じんぶんしゅぎ	人文主義
じんぶんかがく	人文科学
じんぶつひょう	人物評
じんぶつでんき	人物伝記
じんどうしえん	人道支援
じんてきようそ	人的要素
じんてきとうし	人的投資
じんてきしげん	人的資源
じんてきかしつ	人的過失
じんちせんよう	陣地戦用
じんちくむがい	人畜無害
じんだいめいし	人代名詞
じんたいもけい	人体模型
じんそくしょり	迅速処理
じんせいこうろ	人生行路
じんせいくらぶ	人生倶楽部
じんじもんだい	人事問題
じんじぶちょう	人事部長
じんじそしょう	人事訴訟
じんしゅしゅぎ	人種主義
じんしゅさべつ	人種差別
じんざいはけん	人材派遣
じんざいはいち	人材配置
じんこうむのう	人工無能	人工無脳
じんこうみつど	人口密度
じんこうぶんぷ	人口分布
じんこうにゅう	人工乳
じんこうちのう	人工知能
じんこうちせい	人工知性
じんこうぞうき	人工臓器
じんこうぞうか	人口増加
じんこうずのう	人工頭脳
じんこうこうう	人工降雨
じんこうげんご	人工言語
じんこうかみつ	人口過密
じんけんようご	人権擁護
じんけんじょう	人権上
じんけんしそう	人権思想
じんけんきやく	人権規約
じんけんききん	人権基金
じんけんかいぎ	人権会議
じんけんいしき	人権意識
じんがいきょう	人外境
じんいんぶそく	人員不足
じんいんせいり	人員整理
じんいさいがい	人為災害
じれいほうこく	事例報告
じれいはっしん	自励発振
じりつぶんさん	自律分散
じりつしんけい	自律神経
じりつごちょう	自立語長
じりつこうせい	自律更生
じりきこうこう	自力航行
じりきこうかん	自力交換
じりきかいはつ	自力開発
じりきかいけつ	自力解決
じょりゅうきし	女流棋士
じょちゅうぎく	除虫菊
じょそんだんぴ	女尊男卑
じょせききかん	除斥期間
じょせいゆうい	女性優位
じょせいめいし	女性名詞
じょせいべっし	女性蔑視
じょせいふたり	女性二人
じょせいひょう	女性票
じょせいひとり	女性一人
じょせいどうし	女性同士
じょせいとたち	女生徒達
じょせいつりし	女性釣師
じょせいじしん	女性自身
じょせいしんり	女性心理
じょせいしかん	女性士官
じょせいざっし	女性雑誌
じょせいさべつ	女性差別
じょせいさっか	女性作家
じょせいこうほ	女性候補
じょせいぎいん	女性議員
じょせいきゃく	女性客
じょせいかしゅ	女性歌手
じょじょうてき	叙情的
じょしべんじょ	女子便所
じょしてんいん	女子店員
じょしつきのう	除湿機能
じょしだいせい	女子大生
じょしだいがく	女子大学
じょしたんだい	女子短大
じょしたいそう	女子体操
じょしせんしゅ	女子選手
じょししゃいん	女子社員
じょしこうせい	女子高生
じょしこうこう	女子高校
じょしがくせい	女子学生
じょしがくえん	女子学園
じょしがくいん	女子学院
じょざんかいろ	除算回路
じょこうあいし	女工哀史
じょきょきそく	除去規則
じょきょうじゅ	助教授
じょがいきてい	除外規定
じょおうへいか	女王陛下
じょうれんたち	常連達
じょうるりぼん	浄瑠璃本
じょうらくかい	情洛会
じょうようしゃ	乗用車	常用者
じょうもんまえ	縄文前
じょうもんどき	縄文土器
じょうもんすぎ	縄文杉
じょうもんじん	縄文人
じょうめんぞう	上面像
じょうほくせん	城北線
じょうほうろん	情報論
じょうほうもう	情報網
じょうほうばん	情報板
じょうほうなど	情報等
じょうほうとう	情報棟
じょうほうてき	情報的	乗法的
じょうほうつう	情報通
じょうほうだい	情報第	情報大
じょうほうせん	情報戦
じょうほうすじ	情報筋
じょうほうしつ	情報室
じょうほうこう	情報交	情報工
じょうほうげん	情報源
じょうほうけん	情報研
じょうほうけい	情報系
じょうほうくだ	情報下
じょうほうきそ	情報基礎
じょうほうきじ	情報記事
じょうほうきき	情報機器
じょうほうきか	情報幾何
じょうほうがく	情報学
じょうほうかん	情報官	情報館
じょうほうかた	情報過多
じょうぶろかき	上部濾過器
じょうふんべつ	上分別
じょうびきかん	常備期間
じょうばんどう	常磐道
じょうばんせん	常磐線
じょうはんしん	上半身
じょうはつねつ	蒸発熱
じょうはつざら	蒸発皿
じょうはくとう	上白糖
じょうはいじく	上胚軸
じょうのうきん	上納金
じょうねつてき	情熱的
じょうなんどう	上南洞
じょうどしゅう	浄土宗
じょうどきょう	浄土教
じょうどがはま	浄土ヶ浜
じょうとたんぽ	譲渡担保
じょうとうへい	上等兵
じょうとうせん	城東線
じょうとうしき	上棟式
じょうでんけん	情電研
じょうていめん	上底面
じょうつうけん	情通研
じょうちょろん	情緒論
じょうちょてき	情緒的
じょうちょせい	情緒性
じょうちょうど	冗長度
じょうちょうか	冗長化
じょうちゅうぶ	常駐部
じょうちゅうじ	常駐時
じょうちゅうご	常駐後
じょうちゅうげ	上中下
じょうちばしょ	常置場所
じょうだんぬき	冗談抜
じょうたいはん	状態犯
じょうたいすう	状態数
じょうぞうよう	醸造用
じょうぞうもと	醸造元
じょうぞうじょ	醸造所
じょうぞうしょ	醸造所
じょうぞうしゅ	醸造酒
じょうそううん	上層雲
じょうせんけん	乗船券
じょうせつてん	常設展
じょうせついん	浄雪院
じょうせきぶん	上積分
じょうせきどお	定石通
じょうせきてき	定石的
じょうせきけい	定石形
じょうせいほん	上製本	情制本
じょうすうばい	定数倍
じょうすうけん	情数研
じょうすいどう	上水道
じょうじょざん	乗除算
じょうじしよう	常時使用
じょうじかんし	常時監視
じょうしんしょ	上申書
じょうしんえつ	上信越
じょうしょろん	情処論
じょうしょかい	情処会
じょうしょうど	上昇度
じょうしょうじ	上昇時
じょうしゅかく	城主格
じょうしゅうや	上洲屋	上州屋
じょうしゅうじ	上州路
じょうしゃりつ	乗車率
じょうしゃまえ	乗車前
じょうしゃせん	乗車船
じょうしゃけん	乗車券
じょうしゃぐち	乗車口
じょうしゃえき	乗車駅
じょうしゃいち	乗車位置
じょうしきてき	常識的
じょうしきじん	常識人
じょうざんけい	定山渓
じょうさいだい	城西大
じょうこしゃそ	城狐社鼠
じょうこくにん	上告人
じょうこくしん	上告審
じょうこうよう	乗降用
じょうこうせい	上向性
じょうこうしゃ	乗工社
じょうこうぐち	乗降口
じょうげんがく	上限額
じょうげさゆう	上下左右	↑↓←→
じょうげいどう	上下移動
じょうけんめい	条件名
じょうけんほう	條件法	条件法
じょうけんぶん	条件文
じょうけんてき	条件的
じょうけんづけ	条件付	条件付け
じょうけんつき	条件付	条件付き
じょうけんせん	条件戦
じょうけんすう	条件数
じょうけんしき	条件式
じょうきりゆう	上記理由
じょうきょうか	状況下
じょうきゅうき	上級機
じょうきほんぶ	情機本部
じょうきひょう	蒸気表
じょうきくどう	蒸気駆動
じょうききかん	蒸気機関	上記期間
じょうきいがい	上記以外
じょうがいせん	場外戦
じょうかんぱん	上甲板
じょうかんてき	情感的
じょうかそうち	浄化装置
じょうえんけん	上演権
じょうえつせん	上越線
じょうえいかい	上映会
じょういひょう	上位票
じょういばんち	上位番地
じょういにんき	上位人気
じょういどうし	上位同士
じょういしめい	上位指名
じょういごかん	上位互換
じょういげんご	上位言語
じょういきしゅ	上位機種
じょういきかく	上位規格
じょういかたつ	上意下達
じゆうろんぶん	自由論文
じゆうれんそう	自由連想
じゆうりょこう	自由旅行
じゆうみんけん	自由民権
じゆうぼうえき	自由貿易
じゆうほんぽう	自由奔放
じゆうへんすう	自由変数
じゆうはんぐん	自由半群
じゆうはつめい	自由発明
じゆうなんばん	自由軟盤
じゆうとうろん	自由討論
じゆうとうこう	自由投稿
じゆうせきしゃ	自由席車
じゆうせきけん	自由席券
じゆうじっけん	自由実験
じゆうしんぽう	自由新報
じゆうしゃかい	自由社会
じゆうしじょう	自由市場
じゆうこうどう	自由行動
じゆうこうてい	自由行程
じゆうこうえん	自由公演
じゆうけいやく	自由契約
じゆうけいざい	自由経済
じゆうくうかん	自由空間
じゆうがくえん	自由学園
じゆうかいとう	自由回答
じゆううんだい	自由雲台
じゆういっぱん	自由一般
じゆういしろん	自由意志論
じゅんろちょう	順路帳
じゅんようかん	巡洋艦
じゅんまいしゅ	純米酒
じゅんほうこう	順方向
じゅんへんせい	順編成
じゅんぶんがく	純文学
じゅんびぶそく	準備不足
じゅんびちゅう	準備中
じゅんびこうじ	準備工事
じゅんびきかん	準備期間
じゅんびがかり	準備係
じゅんびかてい	準備過程
じゅんびいいん	準備委員
じゅんばんまち	順番待ち
じゅんのうせい	順応性
じゅんどうけい	準同形	準同型
じゅんてんどう	順天堂
じゅんていれい	準定例
じゅんていこう	純抵抗
じゅんたいいん	準隊員
じゅんぜいきん	準税金
じゅんせんゆう	準占有
じゅんせんもん	準専門
じゅんせんけい	準線形
じゅんせいりつ	純正律	純正率
じゅんせいひん	純製品	純正品
じゅんせいてき	準静的
じゅんすいせん	準推薦
じゅんじょてき	順序的
じゅんじょづけ	順序付け	順序付
じゅんじょつい	順序対
じゅんじょせい	順序性
じゅんじょすう	順序数
じゅんじょうは	純情派
じゅんしんむく	純真無垢
じゅんしょとく	純所得
じゅんしゅやく	準主役
じゅんさちょう	巡査長
じゅんさいあか	Cabomboideae	ジュンサイ亜科
じゅんごうとう	準強盗
じゅんごうかん	準強姦
じゅんこくさん	純国産
じゅんこうそく	準光速
じゅんこうしき	準公式
じゅんこうこく	準抗告
じゅんこうかん	巡航艦
じゅんけつしゅ	純血種
じゅんぎんせい	純銀製
じゅんきんせい	純金製
じゅんきょほう	準拠法
じゅんきょすう	純虚数
じゅんきょうち	殉教地
じゅんかんよう	循環用
じゅんかんてき	循環的
じゅんかんせん	循環線
じゅんかんごふ	准看護婦
じゅんかんごし	准看護師
じゅんかんきか	循環器科
じゅんかつざい	潤滑剤	潤滑材
じゅんかいぐん	巡回群
じゅんかいいん	準会員
じゅんおうせい	順応性
じゅんうりあげ	純売上
じゅんいよそう	順位予想
じゅんいひょう	順位表
じゅんいちろう	潤一郎	純一郎	順一郎	淳一郎
じゅんいじゅん	順位順
じゅりょうしょ	受領書
じゅりょういん	受領印
じゅようよそく	需要予測
じゅひょうげん	樹氷原
じゅにんげんど	受忍限度
じゅなんきょく	受難曲
じゅつごろんり	述語論理
じゅつごていぎ	術語定義
じゅつごそうき	術後早期
じゅつごきごう	述語記号
じゅっぷんかん	十分間
じゅっしんほう	十進法
じゅっしんすう	十進数	10進数
じゅっかいてん	十回転
じゅちょうしゃ	受聴者
じゅちょういち	受聴位置
じゅちゅうしゃ	受注者
じゅちゅうざん	受注残
じゅちゅうがく	受注額
じゅしんりょう	受信料
じゅしんつうち	受信通知
じゅしんちゅう	受信中
じゅしんちてん	受信地点
じゅしんそうち	受信装置
じゅしんせつび	受信設備
じゅしんしけん	受信試験
じゅしんけっか	受信結果
じゅしんきょひ	受信拒否
じゅしんかんど	受信感度
じゅしんかいろ	受信回路
じゅしょうしゃ	受賞者	授賞者
じゅしょうしき	授賞式	受賞式
じゅしょうさく	受賞作
じゅこうりょう	受講料
じゅこうぶぶん	受光部分
じゅこうひょう	受講票
じゅこうきのう	受光機能
じゅこうきげん	受講期限
じゅけんりょう	受験料
じゅけんひょう	受験票
じゅけんしほん	授権資本
じゅけんしかく	受験資格
じゅけんざっし	受験雑誌
じゅけんげんご	受験言語
じゅけんきかい	受験機会
じゅけんかもく	受験科目
じゅけんえいご	受験英語
じゅくれんしゃ	熟練者
じゅくれんこう	熟練工
じゅくたつしゃ	熟達者
じゅぎょうよう	授業用
じゅぎょうまえ	授業前
じゅうろくちゃ	十六茶
じゅうろくしん	１６進	十六進
じゅうろくさい	十六歳
じゅうろうどう	重労働
じゅうりょくば	重力場
じゅうりょくは	重力波
じゅうりょうひ	重量比
じゅうりょうさ	重量差
じゅうりょうあ	重量挙
じゅうりゅうし	重粒子
じゅうらいほう	従来法
じゅうらいどお	従来通
じゅうらいてき	従来的
じゅうらいがた	従来型
じゅうよんひき	十四匹
じゅうよんさい	十四歳
じゅうよんおく	十四億
じゅうようてん	重要点
じゅうようせい	重要性
じゅうようさく	重要作
じゅうもうまく	絨毛膜
じゅうみんぜい	住民税
じゅうみんがわ	住民側
じゅうまんほう	充満法
じゅうまんばい	十万倍
じゅうまんにん	十万人
じゅうまんえん	十万円
じゅうほうでん	充放電
じゅうぶんせい	充分性	十分性
じゅうふくぎみ	重複気味
じゅうばこよみ	重箱読み
じゅうはっぱん	十八般
じゅうはちばん	十八番
じゅうはちきん	十八金	18禁
じゅうねんまえ	十年前
じゅうにんなみ	十人並
じゅうにんたち	住人達
じゅうにほうい	十二方位
じゅうにひとえ	十二単
じゅうにきゅう	十二宮
じゅうにかげつ	十二カ月	十二ヶ月
じゅうなんまい	十何枚
じゅうなんねん	十何年
じゅうなんにち	十何日
じゅうなんせい	柔軟性
じゅうなんざい	柔軟剤
じゅうなんかい	十何回
じゅうななにち	十七日
じゅうとうろく	重登録
じゅうとうほう	銃刀法
じゅうでんよう	充電用
じゅうでんしき	充電式
じゅうてんてき	重点的
じゅうてんざい	充填剤
じゅうていおん	重低音
じゅうだんめん	縦断面
じゅうだんせん	十段戦
じゅうだいせい	重大性
じゅうだいしゃ	従台車
じゅうたんさん	重炭酸
じゅうたくよう	住宅用
じゅうたくまえ	住宅前
じゅうたくちず	住宅地図
じゅうたくがい	住宅街
じゅうぞくてき	従属的
じゅうぞくせつ	従属節
じゅうぞくせい	従属性
じゅうぞくこく	従属国
じゅうそうこう	重装甲
じゅうそうかん	重相関	十三間
じゅうせきぶん	重積分
じゅうすうまん	十数万
じゅうすうほん	十数本
じゅうすうふん	十数分
じゅうすうばい	十数倍
じゅうすうねん	十数年
じゅうすうにん	十数人
じゅうすうつう	十数通
じゅうすうかい	十数回
じゅうじほうか	十字砲火
じゅうじつかん	充実感
じゅうじじょう	十字状
じゅうしんてん	重心点
じゅうしんけい	重心系
じゅうしんいち	重心位置
じゅうしょろく	住所録
じゅうしょらん	住所欄
じゅうしょなど	住所等
じゅうしょてき	住所的
じゅうしょあて	住所宛
じゅうしちにち	十七日
じゅうさんびき	十三匹
じゅうさんづか	十三塚
じゅうさんおく	十三億
じゅうさつけい	銃殺刑
じゅうさいぼう	柔細胞
じゅうごうたい	重合体
じゅうこうげき	銃攻撃
じゅうげきせん	銃撃戦
じゅうけんどう	柔剣道
じゅうけいてい	従兄弟
じゅうけいこう	重慶港
じゅうきんぞく	重金属
じゅうきょあと	住居跡
じゅうきねっと	住基ネット
じゅうかんどう	縦貫道
じゅうかんせん	縦貫線
じゅうおうまち	十王町
じゅうえんだま	十円玉
じゅうえいそう	重営倉
じゅういっぴき	十一匹
じゅういちがつ	１１月	十一月	霜月
じゅういちおく	十一億
じゅういがっか	獣医学科
じゅういがくぶ	獣医学部
じゅうあつかん	重厚感	重圧感
じゃんぷりょく	ジャンプ力
じゃりうんぱん	砂利運搬
じゃぽにかまい	ジャポニカ米
じゃっこういん	寂光院
じゃっかんめい	若干名
じゃっかんむり	若干無理
じゃっかんこと	若干異
じゃくれいしゃ	弱冷車
じゃくらんはん	雀卵斑
じゃくはいもの	若輩者
じゃくねんれい	若年齢
じゃくねんそう	若年層
じゃくでんかい	弱電界
じゃくしゃほご	弱者保護
じゃくさんせい	弱酸性
じゃくけいしき	弱形式
じゃくかりょく	弱火力
じゃくえんさん	弱塩酸
じゃいなきょう	ジャイナ教
じもとじちかい	地元自治会
じもとしんぶん	地元新聞
じもとけいさつ	地元警察
じもとがくせい	地元学生
じめんてんかい	字面展開
じむそうちょう	事務総長
じむしょいてん	事務所移転
じむかんきょう	事務環境
じみんどくせん	自民独占
じまくほうそう	字幕放送
じほうばんぐみ	時報番組
じへんしんごう	時変信号
じへいしょうじ	自閉症児
じぶんせんよう	自分専用
じふてりあきん	ジフテリア菌
じびょうたいじ	持病退治
じびいんこうか	耳鼻咽喉科
じひしんちょう	慈悲心鳥
じひしゅっぱん	自費出版
じばんちょうさ	地盤調査
じばさんぎょう	地場産業
じはんきかかく	自販機価格
じはつほうでん	自発放電
じはつてきいし	自発的意志
じねんどいこう	次年度以降
じどうろしゅつ	自動露出
じどうれんけつ	自動連結
じどうほんやく	自動翻訳
じどうへんばい	自動変倍
じどうへんとう	自動返答
じどうへんそく	自動変速
じどうへんそう	自動返送
じどうへんすう	自動変数
じどうへんこう	自動変更
じどうへんかん	自動変換
じどうぶんがく	児童文学
じどうぶんかつ	自動分割
じどうびょうが	自動描画
じどうばんそう	自動伴奏
じどうはんべつ	自動判別
じどうはんてい	自動判定
じどうはつばい	自動発売
じどうはっしん	自動発信
じどうにんしき	自動認識
じどうとうろく	自動登録
じどうとうこう	自動投稿
じどうてんやく	自動点訳
じどうてんめつ	自動点滅
じどうてんそう	自動転送
じどうてきよう	自動適用
じどうていせい	自動訂正
じどうちゃっか	自動着火
じどうたいおう	自動対応
じどうそうしん	自動送信
じどうそうきん	自動送金
じどうせんたく	自動選択
じどうせってい	自動設定
じどうせいせい	自動生成
じどうせいぎょ	自動制御
じどうじゅしん	自動受信
じどうじっこう	自動実行
じどうしゃよう	自動車用
じどうしゃどう	自動車道
じどうしゃぜい	自動車税
じどうしゃじこ	自動車事故
じどうしきべつ	自動識別
じどうさくせい	自動作成
じどうさくじょ	自動削除
じどうごうせい	自動合成
じどうこうしん	自動更新
じどうこうえん	児童公園
じどうけいそく	自動計測
じどうけいさん	自動計算
じどうきりかえ	自動切替	自動切換
じどうきゅうし	自動給紙
じどうきどうじ	自動起動時
じどうがくえん	児童学園
じどうかくてい	自動確定
じどうかいふく	自動回復
じどうかいとう	自動解凍
じどうかいせつ	自動解説
じどうかいさつ	自動改札
じどうかいけつ	自動解結
じどうおうふく	自動往復
じどうおうとう	自動応答
じどうえんそう	自動演奏
じどううんてん	自動運転
じとうてんのう	持統天皇
じてんひょうじ	時点表示
じてんしゅうき	自転周期
じてんしゃれき	自転車歴
じてんしゃよう	自転車用
じてんしゃどう	自転車道
じつろうじかん	実労時間
じつりょくてき	実力的
じつりょくしゃ	実力者
じつりゆうせん	実利優先
じつようほんい	実用本位
じつようねんぴ	実用燃費
じつようじょう	実用上
じつようしゅぎ	実用主義
じつようかいわ	実用会話
じつようかいろ	実用回路
じつむけいけん	実務経験
じつばいかかく	実売価格
じつどうじかん	実働時間
じつたいしょう	実対称
じつぞんしゅぎ	実存主義
じつじきゅうぜ	実事求是
じつじかんせい	実時間性
じつげんふのう	実現不能
じつげんじょう	実現上
じつげんきぼう	実現希望
じつげんきこう	実現機構
じつげんかのう	実現可能
じつげんかてい	実現過程
じつけいさんき	実計算機
じつぎょうだん	実業団
じつぎょうかい	実業界
じつかんきょう	実環境
じつおんじょう	実音場
じつえんじょう	実演場
じっぱひとから	十把一絡
じっちけいけん	実地経験
じったいきょう	実体鏡
じっそくけっか	実測結果
じっそうせいど	実装精度
じっそうじょう	実装上
じっそうしよう	実装仕様
じっそうげんご	実装言語
じっせんりせい	実践理性
じっせんはいび	実戦配備
じっせんさんか	実戦参加
じっせんけっか	実践結果
じっせんからて	実戦空手
じっせきぶそく	実績不足
じっせきしゅぎ	実績主義
じっせいかかく	実勢価格
じっしようこう	実施要項	実施要綱
じっしょうてき	実証的
じっしょうせい	実証性
じっしょうずみ	実証済
じっしゅうよう	実習用
じっしゅうねん	十周年
じっしゅうせい	実習生
じっしゅうしつ	実習室
じっしゅうさき	実習先
じっしゃがめん	実写画面
じっしゃえいが	実写映画
じっしほうほう	実施方法
じっしつちゅう	実質中
じっしつじょう	実質上
じっさいてきな	実際的な
じっさいじょう	実際上
じっこうりょく	実効力	実行力
じっこうふのう	実行不能
じっこうちゅう	実行中
じっこうそくど	実行速度	実効速度
じっこうじかん	実行時間
じっこうけっか	実行結果
じっこうきょか	実行許可
じっこうがめん	実行画面
じっこうかんど	実効感度
じっこうかんし	実行監視
じっこうかのう	実行可能
じっこういらい	実行依頼
じっこういいん	実行委員
じっけんばしょ	実験場所
じっけんづくえ	実験机
じっけんちゅう	実験中
じっけんそうち	実験装置
じっけんせつび	実験設備
じっけんじょう	実験上	実験場
じっけんじたい	実験自体
じっけんじじつ	実験事実
じっけんじかん	実験時間
じっけんしせつ	実験施設
じっけんさんか	実験参加
じっけんげんり	実験原理
じっけんげんば	実験現場
じっけんけっか	実験結果
じっけんきょく	実験局
じっけんきざい	実験器材	実験機材
じっけんかのう	実験可能
じっけんかいし	実験開始
じっけんえいが	実験映画
じっきょうせき	実況席
じっきょうじん	実況陣
じっきょうしゃ	実況者
じちょうけんじ	次長検事
じちぎょうせい	自治行政
じだいはいけい	時代背景
じだいせってい	時代設定
じだいせいしん	時代精神
じだいかんかく	時代感覚
じたくろくおん	自宅録音
じぜんれんらく	事前連絡
じぜんひょうか	事前評価
じぜんとうろく	事前登録
じぜんつうこく	事前通告
じぜんちょうさ	事前調査
じぜんだんたい	慈善団体
じぜんじゅんび	事前準備
じぜんじぎょう	慈善事業
じぜんかつどう	慈善活動
じぜんかくりつ	事前確率
じぜんうんどう	事前運動
じせだいいこう	次世代以降
じすぷろしうむ	Dysprosium	Dy
じすうせいげん	字数制限
じじょどりょく	自助努力
じじょうじばく	自縄自縛
じじょうさよう	自浄作用
じじょうきょり	２乗距離
じじゅうぞうか	自重増加
じじつほうこく	事実報告
じじつにんてい	事実認定
じじつにんしき	事実認識
じじつかんけい	事実関係
じじつかくにん	事実確認
じしんはっせい	地震発生
じしんそうしつ	自信喪失	自身喪失
じしんがっかい	地震学会
じしんかんそく	地震観測
じしんかじょう	自信過剰
じしょばんごう	辞書番号
じしょないよう	辞書内容
じしょとうろく	辞書登録
じしょしっぴつ	辞書執筆
じしょけんさく	辞書検索
じしょけいしき	辞書形式
じしょくねがい	辞職願
じしょうこうい	自傷行為
じしょうくどう	事象駆動
じしゅへんかん	字種変換
じしゅはんだん	自主判断
じしゅはっこう	自主発行
じしゅどくおう	自主独往
じしゅせんゆう	自主占有
じしゅせいさく	自主製作	自主制作
じしゅざいげん	自主財源
じしゅくちゅう	自粛中
じしゅくきかん	自粛期間
じしゅかいはつ	自主開発
じしゅうよこく	次週予告
じしゅういこう	次週以降
じしゃぶぎょう	寺社奉行
じしゃせんない	自社線内
じしゃせいひん	自社製品
じしゃせいさん	自社生産
じしゃかいはつ	自社開発
じさしゅっきん	時差出勤
じごしょうだく	事後承諾
じこりつぞうか	事故率増加
じこふくせいし	自己複製子
じこひょうげん	自己表現
じこちょうせつ	自己調節
じこちゅうしん	自己中心
じこぞうしょく	自己増殖
じこそしきてき	自己組織的
じこそしきけい	自己組織系
じこそうじせい	自己相似性
じこせいとうか	自己正当化	自己正統化
じこじょうほう	自己情報
じこじょうけん	自己条件
じこじゅうたい	事故渋滞
じこしょうめい	事故証明
じこしょうかい	自己紹介
じこしゅちょう	自己主張
じこしゅうふく	自己修復
じこしぼうりつ	事故死亡率
じこさんしょう	自己参照
じこげんきゅう	自己言及
じこけんじよく	自己顕示欲
じこくひょうじ	時刻表示
じこかんしょう	自己干渉
じこかくちょう	自己拡張
じこうさくいん	事項索引
じげんりっぽう	時限立法
じげんばくだん	時限爆弾
じげんくうかん	次元空間
じげんかいせき	次元解析
じけんばんごう	事件番号
じけんかんれん	事件関連
じくたいしょう	軸対称
じくじょうほう	軸情報
じくさくとっき	軸索突起
じくかいせきぶ	字句解析部
じくかいせきき	字句解析器
じくうかんけい	時空関係
じぎょうほんぶ	事業本部
じぎょうぶんや	事業分野
じぎょうぶもん	事業部門
じぎょうぶない	事業部内
じぎょうぶせい	事業部制
じぎょうねんど	事業年度
じぎょうじょう	事業場
じきゅうりょく	持久力
じきゅうじそく	自給自足
じきゅうこうい	自救行為
じきちりょうき	磁気治療器
じきじょうほう	磁気情報
じきしんきしゅ	次期新機種
じきしょうそう	時期尚早
じかんりょこう	時間旅行
じかんほうこう	時間方向
じかんへんどう	時間変動
じかんへんこう	時間変更
じかんへいきん	時間平均
じかんひょうじ	時間表示
じかんはんざい	時間犯罪
じかんはってん	時間発展
じかんはいぶん	時間配分
じかんとくせい	時間特性
じかんそんしつ	時間損失
じかんそくてい	時間測定
じかんせってい	時間設定
じかんせきぶん	時間積分
じかんせいぶん	時間成分
じかんせいげん	時間制限
じかんせいきか	時間正規化
じかんじっけん	時間実験
じかんしんごう	時間信号
じかんざひょう	時間座標
じかんこうぞう	時間構造
じかんげんしゅ	時間厳守
じかんけいれつ	時間系列
じかんけいやく	時間契約
じかんがいねん	時間概念
じかんかんけい	時間関係
じかんかんかく	時間間隔	時間感覚
じかんかじゅう	時間荷重
じかんうんてん	時間運転
じかんいってい	時間一定
じかどうちゃく	自家撞着
じかちゅうどく	自家中毒
じかしゅっぱん	自家出版
じかくそんしつ	時隔損失
じかいもんだい	次回問題
じかいにってい	次回日程
じかいとうこう	次回投稿
じかいしゃけん	次回車検
じかいこうえん	次回公演
じえいたいいん	自衛隊員
じえいせんそう	自衛戦争
じえいしゅだん	自衛手段
じあえんそさん	次亜塩素酸
ざんりゅうぶつ	残留物
ざんりゅうじば	残留磁場
ざんりゅうこじ	残留孤児
ざんりゅうかち	残留価値
ざんりゅうかく	残留核
ざんよざいさん	残余財産
ざんねんむねん	残念無念
ざんねんしょう	残念賞
ざんねんしごく	残念至極
ざんにょうかん	残尿感
ざんていよさん	暫定予算
ざんていしょり	暫定処理
ざんていしょち	暫定処置
ざんていいいん	暫定委員
ざんだかぶそく	残高不足
ざんぞんりょう	残存量
ざんじんざんば	斬人斬馬
ざんしょみまい	残暑見舞い	残暑見舞
ざんさけいれつ	残差系列
ざんぎりあたま	散切り頭
ざんぎょうでい	残業デイ
ざんぎょうだい	残業代
ざんきょうせい	残響性
ざんきょうしつ	残響室
ざんきょうかん	残響感
ざんきょうおん	残響音
ざつようがかり	雑用係
ざつがくていど	雑学程度
ざつがくちしき	雑学知識
ざつおんぶぶん	雑音部分
ざっしれんさい	雑誌連載
ざっしょくせい	雑食性
ざっしほんたい	雑誌本体
ざっししょもつ	雑誌書物
ざっしこうこく	雑誌広告
ざっかはんばい	雑貨販売
ざせきばんごう	座席番号
ざせきていいん	座席定員
ざせきしようじ	座席使用時
ざしきれっしゃ	座敷列車
ざしきでんしゃ	座敷電車
ざおうおんせん	蔵王温泉
ざいりょうてき	材料的
ざいりょうだい	材料代
ざいりょうけい	材料系
ざいむないよう	財務内容
ざいにんちゅう	在任中
ざいにちちゅう	在日中
ざいたくきんむ	在宅勤務
ざいせきちゅう	在籍中
ざいせいくろじ	財政黒字
ざいせいあかじ	財政赤字
ざいじゅうしゃ	在住者
ざいしょくしゃ	在職者
ざいさんぶんり	財産分離
ざいこしょぶん	在庫処分
ざいげんかくほ	財源確保
ざいきんてあて	在勤手当
ざいがくちゅう	在学中
ざいかんちゅう	在官中
ぞくせいぶんぽう	属性文法
ぞくせいひょうか	属性評価
ぞうりょうかのう	増量可能
ぞうびしゃりょう	増備車両
ぞうしょこうせい	蔵書構成
ぞうしょくちゅう	増殖中
ぞうしょくそくど	増殖速度
ぞうごのうりょく	造語能力
ぞうけいびじゅつ	造形美術
ぞうきょうりょう	増強量
ぞうきていきょう	臓器提供
ぞうかんとくせい	増感特性
ぞうかんげんぞう	増感現像
ぞうかきょくせん	増加曲線
ぜんりんかじゅう	前輪荷重
ぜんりょくかそく	全力加速
ぜんりつせんがん	前立腺癌
ぜんようかいめい	全容解明
ぜんもんどうよう	前問同様
ぜんもんせいかい	全問正解
ぜんもんかいとう	全問解答
ぜんめんてんぼう	前面展望
ぜんめんてったい	全面撤退
ぜんめんちゅうし	全面中止
ぜんめんたいけつ	全面対決
ぜんめんせんそう	全面戦争
ぜんめんさんせい	全面賛成
ぜんめんこうこく	全面広告
ぜんめんきんえん	全面禁煙
ぜんめんかんつう	前面貫通
ぜんめんかいてい	全面改定
ぜんめつせんそう	全滅戦争
ぜんめつすんぜん	全滅寸前
ぜんぽうかいてん	前方回転
ぜんべいしんこう	全米侵攻
ぜんべいこうかい	全米公開
ぜんべいがくせい	全米学生
ぜんぶんいんよう	全文引用
ぜんぶざせきよう	前部座席用
ぜんはんこうはん	前半後半
ぜんにほんじょし	全日本女子
ぜんにほんくうゆ	全日本空輸
ぜんにっくうびん	全日空便
ぜんなんぜんにょ	善男善女
ぜんとりょうえん	前途遼遠
ぜんとうぶじょは	前頭部徐波
ぜんてんせんぶん	全天線分
ぜんてんこうがた	全天候型
ぜんだんめんせき	全断面積
ぜんたいほうしん	全体方針
ぜんたいひょうか	全体評価
ぜんたいこうせい	全体構成
ぜんたいこうげき	全体攻撃
ぜんぜんもんだい	全然問題
ぜんせんほうそう	全戦放送
ぜんせんふくせん	全線複線
ぜんせんたんせん	全線単線
ぜんせんぜんえき	全線全駅
ぜんせんかいつう	全線開通
ぜんせききんえん	全席禁煙
ぜんせいめいたい	全生命体
ぜんすうちょうさ	全数調査
ぜんじんかくてき	全人格的
ぜんじょうきゃく	全乗客
ぜんじゅんそうさ	前順走査
ぜんじゅうりょう	全重量
ぜんじつせつえい	前日設営
ぜんしんぜんれい	全身全霊
ぜんしんしゃしん	全身写真
ぜんしんうんどう	全身運動
ぜんしょくぎょう	前職業
ぜんしょうきごう	全称記号
ぜんしゅうはすう	全周波数
ぜんしつきんえん	全室禁煙
ぜんこくほうそう	全国放送
ぜんこくほうえい	全国放映
ぜんこくへいきん	全国平均
ぜんこくはんばい	全国販売
ぜんこくはつばい	全国発売
ぜんこくてんかい	全国展開
ぜんこくちょうさ	全国調査
ぜんこくたいかい	全国大会
ぜんこくせんばつ	全国選抜
ぜんこくじんこう	全国人口
ぜんこくこうせん	全国高専
ぜんこくこうこう	全国高校
ぜんこくこうかい	全国公開
ぜんこくいっせい	全国一斉
ぜんこうしゃりん	前後車輪
ぜんこうしきせん	全公式戦
ぜんこうがくてき	全光学的
ぜんげんてっかい	前言撤回
ぜんけんかんとく	全権監督
ぜんけいせいそう	前形成層
ぜんぎんてじゅん	全銀手順
ぜんきんだいてき	前近代的
ぜんきょくちゅう	全曲中
ぜんきょくしゅう	全曲集
ぜんきょくさくし	全曲作詞
ぜんきゆうしょう	前期優勝
ぜんきつえんしゃ	全喫煙者
ぜんきしゅせいは	全機種制覇
ぜんがくめんじょ	全額免除
ぜんがくむしょう	全額無償
ぜんがくへんきん	全額返金
ぜんがくはいとう	全額配当
ぜんがくだいきん	全額代金
ぜんがくしきゅう	全額支給
ぜんかんきんえん	全館禁煙
ぜんかくはんかく	全角半角
ぜんかいれいかい	前回例会
ぜんかいどうよう	前回同様
ぜんかいとうしゃ	全回答者
ぜんかいとうこう	前回投稿
ぜんかいてんいき	全回転域
ぜんかいたんさく	全解探索
ぜんかいせんたく	前回選択
ぜんかいじゅんい	前回順位
ぜんかいこうそう	前回好走
ぜんかいこうえん	前回公演
ぜんえききんえん	全駅禁煙
ぜんえいびじゅつ	前衛美術
ぜんいんしんにん	全員信任
ぜにがたあざらし	銭形海豹
ぜつめつどうぶつ	絶滅動物
ぜつめつすんぜん	絶滅寸前
ぜつめつきぐしゅ	絶滅危惧種
ぜつえんふりょう	絶縁不良
ぜつえんせんげん	絶縁宣言
ぜつえんえきたい	絶縁液体
ぜついんしんけい	舌咽神経
ぜったいれんぞく	絶対連続
ぜったいひょうか	絶対評価
ぜったいひつよう	絶対必要
ぜったいぱすめい	絶対パス名
ぜったいはんたい	絶対反対
ぜったいとうせん	絶対当選
ぜったいてきいみ	絶対的意味
ぜったいぜつめい	絶体絶命
ぜったいせいのう	絶対性能
ぜったいざひょう	絶対座標
ぜったいおんかん	絶対音感
ぜっこうせんげん	絶交宣言
ぜいたくざんまい	贅沢三昧
ぜいせいかいかく	税制改革
ぜいしゅうにゅう	税収入
ぜいきんもんだい	税金問題
ぜいきんどろぼう	税金泥棒
ぜいきんこうじょ	税金控除
ぜいきんかんけい	税金関係
ぜいがくこうじょ	税額控除
ずひょうばんごう	図表番号
ずけいへんしゅう	図形編集
ずいはんけいすう	随伴係数
ずいはんかんしゅ	随伴函手
ずいじはっぴょう	随時発表
じんるいめつぼう	人類滅亡
じんるいはんえい	人類繁栄
じんるいはっせい	人類発生
じんるいぜんたい	人類全体
じんるいしじょう	人類史上
じんるいかちくか	人類家畜化
じんりきひこうき	人力飛行機
じんめいゆうせん	人命優先
じんみんぶんがく	人民文学
じんみんにっぽう	人民日報
じんぶんちりがく	人文地理学
じんぶんがくしゃ	人文学者
じんぶんかがくぶ	人文科学部
じんぶつはんてい	人物判定
じんぶつさつえい	人物撮影
じんぴんこつがら	人品骨柄
じんどうもんだい	人道問題
じんてきしょうこ	人的証拠
じんていじんもん	人定尋問
じんていしつもん	人定質問
じんちゅうみまい	陣中見舞
じんたいたんさく	人体探索
じんたいじっけん	人体実験
じんぞうにんげん	人造人間
じんぞうけっせき	腎臓結石
じんせいもんだい	人生問題
じんせいてつがく	人生哲学
じんせいそうだん	人生相談
じんせいぜんぱん	人生全般
じんせいせっけい	人生設計
じんせいさいだい	人生最大
じんせいごくらく	人生極楽
じんせいけいけん	人生経験
じんじゃぶっかく	神社仏閣
じんじいいんかい	人事委員会
じんしんほごほう	人身保護法
じんしんばいばい	人身売買
じんしゅもんだい	人種問題
じんしゅこくせき	人種国籍
じんざいようせい	人材養成
じんざいぼしゅう	人材募集
じんざいさくげん	人材削減
じんざいけいせい	人材形成
じんざいいくせい	人材育成
じんこうわくせい	人工惑星
じんこうよくせい	人口抑制
じんこうばくはつ	人口爆発
じんこうどうたい	人口動態
じんこうとうせき	人工透析
じんこうとうけい	人口統計
じんこうちょうさ	人口調査
じんこうちのうや	人工知能屋
じんこうたつまき	人工竜巻
じんこうせいめい	人工生命
じんこうじゅせい	人工受精	人工授精
じんこうしんぱい	人工心肺
じんこうしんぞう	人工心臓
じんこうしんけい	人工神経
じんこうこきゅう	人工呼吸
じんこうこうもん	人工肛門
じんこうこうせつ	人工降雪
じんこうげんじつ	人工現実
じんこうけつえき	人工血液
じんこうかいすい	人工海水
じんこうおんせい	人工音声
じんこうえいせい	人工衛星
じんけんよくあつ	人権抑圧
じんけんもんだい	人権問題
じんけんだんたい	人権団体
じんけんせんげん	人権宣言
じんけんしんぱん	人権侵犯
じんけんしんがい	人権侵害
じんけんかんかく	人権感覚
じんぐうしちょう	神宮司庁
じんぐうこうごう	神功皇后
じんがいまきょう	人外魔境
じんかくこうげき	人格攻撃
じんかくけいせい	人格形成
じんかくかいぞう	人格改造
じんいんぼしゅう	人員募集
じんいんさくげん	人員削減
じれいしょうかい	事例紹介
じりょくかいそう	自力回送
じりつがたいどう	自立型移動
じりきゆうしょう	自力優勝
じようきょうそう	滋養強壮
じょりゅうさっか	女流作家
じょめいてんのう	舒明天皇
じょめいしょぶん	除名処分
じょせいゆうせん	女性優先
じょせいもんだい	女性問題
じょせいへんれき	女性遍歴
じょせいたんどく	女性単独
じょせいせんよう	女性専用
じょせいせんしゅ	女性選手
じょせいしょこん	女性初婚
じょせいしゃいん	女性社員
じょせいさいこん	女性再婚
じょせいきんがく	助成金額
じょせいきょうゆ	女性教諭
じょせいきょうし	女性教師
じょせいかんけい	女性関係
じょせいいっぱん	女性一般
じょしゅせきよう	助手席用
じょしゅせきがわ	助手席側
じょしやきゅうぶ	女子野球部
じょしゃせきよう	助者席用
じょしちゅうせい	女子中生
じょしけいむしょ	女子刑務所
じょしきょうえい	女子競泳
じょざんれいがい	除算例外
じょこううんてん	徐行運転
じょけんはんけつ	除権判決
じょえんだんゆう	助演男優
じょえんじょゆう	助演女優
じょうれんきゃく	常連客
じょうれいじゅつ	浄霊術
じょうれいしゅう	条例集
じょうりょくじゅ	常緑樹
じょうりゅうすい	蒸留水
じょうりゅうじょ	蒸留所
じょうりゅうしゅ	蒸留酒
じょうらんずもう	上覧相撲
じょうようかんじ	常用漢字
じょうやくいはん	条約違反
じょうもんぶんか	縄文文化
じょうもんぜんき	縄文前期
じょうもんじだい	縄文時代
じょうもんこうき	縄文後期
じょうもんいぜん	縄文以前
じょうむこうたい	乗務交代
じょうむいんよう	乗務員用
じょうむいんしつ	乗務員室
じょうみゃくけつ	静脈血
じょうほうろんり	情報論理
じょうほうりろん	情報理論
じょうほうりょく	情報力
じょうほうりょう	情報量	情報料
じょうほうりがく	情報理学
じょうほうほんぶ	情報本部
じょうほうぶんや	情報分野
じょうほうぶそく	情報不足
じょうほうぶいん	情報部員
じょうほうはいふ	情報配布
じょうほうどうし	情報同士
じょうほうちしき	情報知識
じょうほうちかん	上方置換
じょうほうそうさ	情報操作
じょうほうすうり	情報数理
じょうほうしょり	情報処理
じょうほうざっし	情報雑誌
じょうほうきょく	情報局
じょうほうききぶ	情報機器部
じょうほうきおく	情報記憶
じょうほうがっか	情報学科
じょうほうがくぶ	情報学部
じょうほうかんり	情報管理
じょうほうかでん	情報家電
じょうほうかくさ	情報格差
じょうほうかがく	情報科学
じょうほうかいじ	情報開示
じょうほういがい	情報以外
じょうぶんきてい	条文規定
じょうぶこうぞう	上部構造
じょうはつそくど	蒸発速度
じょうはつそうち	蒸発装置
じょうにんいいん	常任委員
じょうなんでんき	城南電器
じょうなんちょう	城南町
じょうとしょとく	譲渡所得
じょうちょうせい	冗長性
じょうちゅうもの	常駐物
じょうちゅうがた	常駐型
じょうちゃくまく	蒸着膜
じょうちゃくそう	蒸着層
じょうちだいがく	上智大学
じょうたいりょう	状態量
じょうたいへんか	状態変化
じょうたいせんい	状態遷移
じょうたいずない	状態図内
じょうせんりょう	乗船料
じょうせつばしょ	常設場所
じょうせつてんじ	常設展示
じょうせきひょう	乗積表
じょうせきしゅう	定石集
じょうすうじかん	定数時間
じょうすうこうか	乗数効果
じょうすいじょう	浄水場
じょうじょうきち	上々吉
じょうじゅんごろ	上旬頃
じょうじてんとう	常時点灯
じょうじせつぞく	常時接続
じょうじけいたい	常時携帯
じょうじかいほう	常時開放
じょうじかいてん	常時回転
じょうしんでんき	上新電機
じょうしょうりつ	上昇率
じょうしょうはば	上昇幅
じょうしょうがた	上昇型
じょうしょうかん	上昇管
じょうしょうかく	上昇角
じょうしょうおん	上昇音
じょうしゅうはん	常習犯
じょうしゅうしゃ	常習者
じょうしゃりょう	乗車料
じょうしゃひょう	乗車票
じょうしゃとびら	乗車扉
じょうしゃそうち	乗車装置
じょうしゃせんび	乗車船日
じょうしゃじかん	乗車時間
じょうしゃけいろ	乗車経路
じょうしゃくかん	乗車区間
じょうしゃきんし	乗車禁止
じょうしゃきろく	乗車記録
じょうしゃきょひ	乗車拒否
じょうしゃきゃく	乗車客
じょうしゃかのう	乗車可能
じょうしきちゅう	常識中
じょうしきいぜん	常識以前
じょうざんそうさ	乗算操作
じょうざんかいろ	乗算回路
じょうこくちゅう	上告中
じょうこくきかん	上告期間
じょうこうひんど	乗降頻度
じょうこうじかん	乗降時間
じょうこうきゃく	乗降客
じょうげんかげん	上限下限
じょうげんかかく	上限価格
じょうげんいない	上限以内
じょうげやじるし	上下矢印
じょうげほうこう	上下方向
じょうげぶんさつ	上下分冊
じょうげぶんかつ	上下分割
じょうげすいどう	上下水道
じょうげかんけい	上下関係
じょうげかんかく	上下間隔
じょうげうんどう	上下運動
じょうけんぶんき	条件分岐
じょうけんぶぶん	条件部分
じょうけんていじ	条件提示
じょうけんしだい	条件次第
じょうけんおんど	条件温度
じょうけんいはん	条件違反
じょうきろんぶん	上記論文
じょうきゅうよう	上級用
じょうきゅうへん	上級編
じょうきゅうひん	上級品
じょうきゅうせい	上級生
じょうきゅうしん	上級審
じょうきゅうしゃ	上級者
じょうきゃくぞう	乗客増
じょうきゃくすう	乗客数
じょうきもくてき	上記目的
じょうきほうほう	上記方法
じょうきはつげん	上記発言
じょうきないよう	上記内容
じょうきてじゅん	上記手順
じょうきせんげん	上記宣言
じょうきせいめい	上記声明
じょうきしつもん	上記質問
じょうきかいごう	上記会合
じょうがんじがわ	常願寺川
じょうおうへいか	女王陛下
じょうえんちゅう	上演中
じょうえいちゅう	上映中
じょうえいじかん	上映時間
じょうえいきんし	上映禁止
じょういんぎいん	上院議員
じょういどくせん	上位独占
じょういしゅぞく	上位種族
じょういごかんき	上位互換機
じょういけいさい	上位掲載
じょういがいねん	上位概念
じょういかいそう	上位階層
じゆうりょういき	自由領域
じゆうじゅんぐん	自由準群
じゆうしゅつげん	自由出現
じゆうしゅぎてき	自由主義的
じゆうしゅぎしゃ	自由主義者
じゆうさいりょう	自由裁量
じゆうけんきゅう	自由研究
じゆうきょくめん	自由曲面
じゆうきょうそう	自由競争
じゆうおんじょう	自由音場
じゅんろんりてき	純論理的
じゅんろへんこう	順路変更
じゅんれいきゃく	巡礼客
じゅんりろんてき	純理論的
じゅんりゅうさん	純硫酸
じゅんようきてい	準用規定
じゅんゆうしょう	準優勝
じゅんぴつりょう	潤筆料
じゅんびてつづき	準備手続
じゅんびだんかい	準備段階
じゅんびしょめん	準備書面
じゅんびさぎょう	準備作業
じゅんびかつどう	準備活動
じゅんびうんどう	準備運動
じゅんばんひょう	順番表
じゅんばんいがい	順番以外
じゅんなてんのう	淳和天皇
じゅんとくじょし	潤徳女子
じゅんとうしょう	順当勝
じゅんていじょう	準定常
じゅんたんしょく	準単色
じゅんたいじょし	準体助詞
じゅんそくたつか	準速達化
じゅんせんりゃく	純戦略
じゅんせいぶひん	純正部品
じゅんせいちょう	純正調
じゅんせいじょう	準正常
じゅんせいがいぶ	純正外部
じゅんせいいがい	純正以外
じゅんすいろんり	純粋論理
じゅんすいりせい	純粋理性
じゅんすいぶつり	純粋物理
じゅんじょちかく	順序知覚
じゅんじょきかい	順序機械
じゅんじょかいろ	順序回路
じゅんじどくりつ	順次独立
じゅんじじっこう	順次実行
じゅんじしんこう	順次進行
じゅんじしゅっか	順次出荷
じゅんじけんさく	順次検索
じゅんじかくてい	順次確定
じゅんしんじょし	純心女子	順心女子
じゅんしょくしゃ	殉職者
じゅんしゅじこう	遵守事項
じゅんしどういん	準指導員
じゅんさぶちょう	巡査部長
じゅんこうむいん	準公務員
じゅんこうちゅう	巡行中	巡航中
じゅんこうそくど	巡行速度	巡航速度
じゅんけつしゅぎ	純血主義
じゅんけっしょう	準結晶	準決勝
じゅんぎょうさき	巡業先
じゅんきょきやく	準拠規約
じゅんきょうゆう	準共有
じゅんきょうじゅ	准教授	準教授
じゅんきょうしゃ	殉教者
じゅんきゅうよう	準急用
じゅんきゅうこう	準急行
じゅんかんていり	循環定理
じゅんかんきのう	循環機能
じゅんかんきしつ	循環気質
じゅんかんきけい	循環器系
じゅんかんきかん	循環器官
じゅんかんかてい	循環過程
じゅんかがくてき	純科学的
じゅんかいちゅう	巡回中
じゅんいけってい	順位決定
じゅんあつたいき	順圧大気
じゅりょうちたい	受領遅滞
じゅりょうしょう	受領証
じゅりじょうたい	受理状態
じゅようこうぞう	需要構造
じゅもんこうげき	呪文攻撃
じゅもくすうはい	樹木崇拝
じゅどうきつえん	受動喫煙
じゅつごていすう	述語定数
じゅつごけいさん	述語計算
じゅっしゅうねん	十周年
じゅたくはんばい	受託販売
じゅじょうとっき	樹状突起
じゅじょうかいろ	樹状回路
じゅしんふかのう	受信不可能
じゅしんじっけん	受信実験
じゅしんけいしき	受信形式
じゅしんかいすう	受信回数
じゅこうめんせき	受光面積
じゅこうへいめん	受光平面
じゅこうさいぼう	受光細胞
じゅけんばんごう	受験番号
じゅけんせんそう	受験戦争
じゅけんすうがく	受験数学
じゅけんじゅんび	受験準備
じゅけんしゃすう	受験者数
じゅけんかいすう	受験回数
じゅくねんりこん	熟年離婚
じゅぎょうりょう	授業料
じゅぎょうちゅう	授業中
じゅぎょうじかん	授業時間
じゅぎょうかもく	授業科目
じゅぎょういがい	授業以外
じゅかせきじょう	樹下石上
じゅうりょくじば	重力磁場
じゅうりょくしき	重力式
じゅうりょくげん	重力源
じゅうりょくけい	重力計	重力系
じゅうりょくいど	重力井戸
じゅうりょうぶつ	重量物
じゅうりょうてき	重量的
じゅうりょうぜい	重量税	従量税
じゅうりょうせい	従量制
じゅうりょうしゃ	重量車
じゅうりょうけい	重量計
じゅうりょうかん	重量感
じゅうりょうあげ	重量挙げ
じゅうらいきしゅ	従来機種
じゅうらいきかく	従来規格
じゅうようじこう	重要事項
じゅうようぎだい	重要議題
じゅうようきみつ	重要機密
じゅうようかだい	重要課題
じゅうもんじばし	十文字橋
じゅうみんひょう	住民表	住民票
じゅうまんおくど	十万億土
じゅうぶんかのう	十分可能
じゅうぶんかくほ	十分確保
じゅうびょうにん	重病人
じゅうばんみてい	重版未定
じゅうばくげきき	重爆撃機
じゅうのうしゅぎ	重農主義
じゅうにんといろ	十人十色
じゅうにしちょう	十二指腸
じゅうなんぎょう	十何行
じゅうどうじょう	柔道場
じゅうとざんぐつ	重登山靴
じゅうとこうだん	住都公団
じゅうでんりょう	充電量
じゅうでんちゅう	充電中
じゅうでんじかん	充電時間
じゅうでんきかん	充電期間
じゅうでんかのう	充電可能
じゅうだんきこう	縦断紀行
じゅうたくほじょ	住宅補助
じゅうたくひよう	住宅費用
じゅうたくてあて	住宅手当
じゅうたくだんち	住宅団地
じゅうたくせつび	住宅設備
じゅうたいちゅう	渋滞中
じゅうたいかんわ	渋滞緩和
じゅうたいかくご	渋滞覚悟
じゅうそくふのう	充足不能
じゅうそくかのう	充足可能
じゅうそうきょく	重奏曲
じゅうそうきへい	重装機兵
じゅうすうびょう	十数秒
じゅうすうきょく	十数局
じゅうじょうえき	十条駅
じゅうじたいせい	十字対生
じゅうしんいどう	重心移動
じゅうしょふめい	住所不明
じゅうしょふてい	住所不定
じゅうしょしめい	住所氏名
じゅうしょうがい	重障害
じゅうさんじょう	十三条
じゅうこうぎょう	重工業
じゅうけいしょう	重軽傷
じゅうぐんしさい	従軍司祭
じゅうぐんきしゃ	従軍記者
じゅうぎょういん	従業員
じゅうきゅうさい	十九歳
じゅうきこうへい	重機甲兵
じゅうかんきょう	住環境
じゅうかさんぜい	重加算税
じゅうおうむじん	縦横無尽
じゅうおうむぐう	縦横無隅
じゅういがっこう	獣医学校
じゃっかんりょう	若干量
じゃっかんゆうり	若干有利
じゃっかんふあん	若干不安
じゃくめついらく	寂滅為楽
じゃくしょうこく	弱小国
じゃくししゃよう	弱視者用
じもとみっちゃく	地元密着
じもとちょうみん	地元町民
じもとせんしゅつ	地元選出
じもとしょうぼう	地元消防
じもとしゅっしん	地元出身
じもとしこうせい	地元指向性
じむれんらくよう	事務連絡用
じむぶちょうしつ	事務部長室
じむてすうりょう	事務手数料
じむてきれんらく	事務的連絡
じむたんとうしゃ	事務担当者
じむしょりひよう	事務処理費用
じむしょかんけい	事務所関係
じむきょくちょう	事務局長
じむきょくだいり	事務局代理
じぶんちゅうしん	自分中心
じぶんかつしょり	時分割処理
じひつしょうしょ	自筆証書
じばいせきほけん	自賠責保険
じはつてきさんか	自発的参加
じどうれんけつき	自動連結器
じどうみぎそろえ	自動右揃え
じどうまきもどし	自動巻き戻し
じどうほんやくき	自動翻訳機
じどうへんそくき	自動変速機
じどうへいれつか	自動並列化
じどうふくしほう	児童福祉法
じどうはんばいき	自動販売機
じどうにんぎょう	自動人形
じどうにりんしゃ	自動二輪車
じどうとうひょう	自動投票
じどうついじゅう	自動追従
じどうちょうせい	自動調整
じどうそうちゃく	自動装着
じどうそうじゅう	自動操縦
じどうせんたくき	自動洗濯機
じどうせんしゃき	自動洗車機
じどうせいさんき	自動精算機	自動清算機
じどうしょうめつ	自動消滅
じどうしょうめい	自動証明
じどうしゅうせい	自動修正
じどうしゅうけい	自動集計
じどうしゃようご	自動車用語
じどうしゃゆそう	自動車輸送
じどうしゃほけん	自動車保険
じどうしゃぶんか	自動車文化
じどうしゃどうろ	自動車道路
じどうしゃでんわ	自動者電話	自動車電話
じどうしゃざっし	自動車雑誌
じどうしゃかさい	自動車火災
じどうしゃいがい	自動車以外
じどうしはらいき	自動支払機
じどうさっきょく	自動作曲
じどうけんばいき	自動券売機
じどうけんしょう	自動検証
じどうけんしゅつ	自動検出
じどうぎゃくたい	児童虐待
じどうかんそうき	自動乾燥機
じどうかいひょう	自動開票
じどうかいちょう	児童会長
じどうかいさつき	自動改札機
じどうかいさつか	自動改札化
じどうかいぎょう	自動改行
じどうえんちょう	自動延長
じてんしゃぶひん	自転車部品
じてんしゃざっし	自転車雑誌
じてんしゃくかん	自転車区間
じてんしゃおきば	自転車置場
じてんしゃいどう	自転車移動
じつりょくぶそく	実力不足
じつりょくひかく	実力比較
じつりょくどおり	実力通り
じつりょくしゅぎ	実力主義
じつりょくこうし	実力行使
じつようしんあん	実用新案
じつようかじだい	実用化時代
じつぶつとりひき	実物取引
じつどうさじょう	実動作上
じつじかんしょり	実時間処理
じつげんほうほう	実現方法
じつげんふかのう	実現不可能
じつげんしゅほう	実現手法
じつげんけいたい	実現形態
じつげんぎじゅつ	実現技術
じつぎこうしゅう	実技講習
じつえんはんばい	実演販売
じつあっしゅくひ	実圧縮比
じっぱひとからげ	十把一絡	十把一絡げ
じっちょうりょく	実張力
じっちゅうはっく	十中八九
じっちけんしょう	実地検証
じっちけんしゅう	実地研修
じっちえんしゅう	実地演習
じったいちょうさ	実態調査
じったいけんしゃ	実体験者
じったいがいねん	実体概念
じっそうめんせき	実装面積
じっそうほうほう	実装方法
じっそうほうしき	実装方式
じっそうぎじゅつ	実装技術
じっせんけいけん	実戦経験
じっせきちょうさ	実績調査
じっせきじゅうし	実績重視
じっすうていすう	実数定数
じっすうぜんたい	実数全体
じっしようりょう	実施要領
じっしょうしゅぎ	実証主義
じっしゅきょうぎ	十種競技
じっしゅうそうち	実習装置
じっしゃほうしき	実写方式
じっしつふくいん	実質幅員
じっしつちんぎん	実質賃金
じっしつぞうぜい	実質増税
じっさいもんだい	実際問題
じっさいえいぞう	実際映像
じっこうほうほう	実行方法
じっこうほうしき	実行方式
じっこうへんかん	実行変換
じっこうふかのう	実行不可能
じっこうとちゅう	実行途中
じっこうてじゅん	実行手順
じっこうてきいみ	実効的意味
じっこうだんかい	実行段階
じっこうぞくせい	実行属性
じっこうぜいりつ	実効税率
じっこうせいのう	実行性能
じっこうじっせき	実行実績
じっこうしゅたい	実行主体
じっこうこうりつ	実行効率
じっこうけんげん	実行権限
じっこうけいれつ	実行系列
じっこうけいしき	実行形式
じっこうけいかく	実行計画
じっこうかいすう	実行回数
じっけんろんぶん	実験論文
じっけんもくてき	実験目的
じっけんほうほう	実験方法
じっけんほうそう	実験放送
じっけんほうこく	実験報告
じっけんばんぐみ	実験番組
じっけんないよう	実験内容
じっけんどうぶつ	実験動物
じっけんだんかい	実験段階
じっけんせつぞく	実験接続
じっけんすうがく	実験数学
じっけんじゅんび	実験準備
じっけんしゅほう	実験手法
じっけんしゅたい	実験主体
じっけんしつけい	実験室系
じっけんごさない	実験誤差内
じっけんけいかく	実験計画
じっけんぎじゅつ	実験技術
じっけんかいせき	実験解析
じっけんかいしご	実験開始後
じっけいはんけつ	実刑判決
じっかいせきせい	実解析性
じちいかだいがく	自治医科大学
じだんこうしょう	示談交渉
じだいしょうせつ	時代小説
じだいさくごてき	時代錯誤的
じだいこうしょう	時代考証
じたくりょうよう	自宅療養
じたくとうちゃく	自宅到着
じぜんよやくよう	事前予約要
じぜんはっぴょう	事前発表
じぜんじょうけん	事前条件
じぜんこうにゅう	事前購入
じぜんがくしゅう	事前学習
じじょうへいきん	二乗平均
じじょうせつめい	事情説明
じじょうごさほう	二乗誤差法
じじょうけんてい	二乗検定
じじつうしんしゃ	時事通信社
じしんじょうほう	地震情報
じしょじょうほう	辞書情報
じしょがくしゅう	辞書学習
じしょうさけつう	自称酒通
じしゅじょうえい	自主上映
じしゅこうぎょう	自主興行
じしゅうえんがた	次周縁型
じさつかんよざい	自殺関与罪
じさくちゅうしん	自作中心
じさくしゃりょう	自作車両
じこもくてきせい	自己目的性
じこめんえきけい	自己免疫系
じこむどうちゃく	自己無撞着
じこぼうしこうか	事故防止効果
じこぼうえいさく	自己防衛策
じこはんえいてき	自己反映的
じこはっせいりつ	事故発生率
じこどうけいぐん	自己同型群
じこどういつせい	自己同一性
じことうすいてき	自己陶酔的
じこてんめつがた	自己点滅型
じこてんかいせい	自己展開性
じこてきようてき	自己適用的
じこちゅうしんは	自己中心派
じこそしきかほう	自己組織化法
じこそしきかいろ	自己組織回路
じこしほんひりつ	自己資本比率
じこけっていけん	自己決定権
じこきゅうしゅう	自己吸収
じこかんけつてき	自己完結的
じこかんけつがた	自己完結型
じこかいぜんせい	自己改善性
じこうほせんたく	次候補選択
じこうだいにごう	次項第二号
じこいちすいてい	自己位置推定
じげんいいんかい	時限委員会
じけんはっかくご	事件発覚後
じけいれつようそ	時系列要素
じけいれつじゅん	時系列順
じけいれつしょり	時系列処理
じくせんきんぼう	軸線近傍
じぎょうようしゃ	事業用車
じぎょうぶちょう	事業部長
じぎょうないよう	事業内容
じぎょうてんかい	事業展開
じぎょうすいしん	事業推進
じぎょうしょない	事業所内
じぎょうしょとく	事業所得
じぎょうしょぜい	事業所税
じぎょうしょかん	事業所間
じぎょうしゃがわ	事業者側
じぎょうけいかく	事業計画
じぎょうかつどう	事業活動
じきてきへんどう	時期的変動
じかんわりひょう	時間割表
じかんりょういき	時間領域
じかんむせいげん	時間無制限
じかんまどちょう	時間窓長
じかんへいきんち	時間平均値
じかんてきよゆう	時間的余裕
じかんてきけいか	時間的経過
じかんちょうせい	時間調整
じかんたんしゅく	時間短縮
じかんたいきゅう	時間耐久
じかんじょうほう	時間情報
じかんじくじょう	時間軸上
じかんしょうとつ	時間衝突
じかんがいてあて	時間外手当
じかんがいせかい	時間外世界
じかんがいかさん	時間外加算
じかんえいぎょう	時間営業
じかいこうぎょう	次回興業
じえいたいさんか	自衛隊参加
じえいぎょうしゃ	自営業者
じいしきかじょう	自意識過剰
ざんりゅうしねん	残留思念
ざんていせいけん	暫定政権
ざんぞんちょうや	残存聴野
ざんさへいほうわ	残差平方和
ざんさひょうかち	残差評価値
ざんぎょうてあて	残業手当
ざんぎょうじかん	残業時間
ざんぎょうしょく	残業食
ざんぎゃくひどう	残虐非道
ざんぎゃくじけん	残虐事件
ざんぎゃくこうい	残虐行為
ざんきょうりろん	残響理論
ざんきょうじかん	残響時間
ざひょうへんかん	座標変換
ざひょうひょうじ	座標表示
ざひょうけいさん	座標計算
ざつだんはんぶん	雑談半分
ざつおんよくせい	雑音抑制
ざつおんよくあつ	雑音抑圧
ざつおんじょきょ	雑音除去
ざつおんしんごう	雑音信号
ざっしれんさいじ	雑誌連載時
ざっしゅうにゅう	雑収入
ざっしけいさいじ	雑誌掲載時
ざっしきょうかい	雑誌協会
ざせきしていせい	座席指定制
ざせきしていけん	座席指定券
ざいりょうがっか	材料学科
ざいりょうかがく	材料科学
ざいらいてつどう	在来鉄道
ざいらいぎじゅつ	在来技術
ざいむじょうたい	財務状態
ざいむしょひょう	財務諸表
ざいばつかいたい	財閥解体
ざいにちべいぐん	在日米軍
ざいにちかんこく	在日韓国
ざいだんほうじん	財団法人
ざいだんさいけん	財団債権
ざいせいたんとう	財政担当
ざいせいじじょう	財政事情
ざいせいしゅうし	財政収支
ざいせいししゅつ	財政支出
ざいしょくちゅう	在職中
ざいしつひょうじ	材質表示
ざいさんもくろく	財産目録
ざいさんそうぞく	財産相続
ざいごうぐんじん	在郷軍人
ざいこちょうせい	在庫調整
ざいけいちょちく	財形貯蓄
ざいがいほうじん	在外邦人
ざいがいこうかん	在外公館
ぞろあすたーきょう	ゾロアスター教
ぞくせいひょうかき	属性評価器
ぞくせいちしゅどう	属性値主導
ぞくせいじょうけん	属性条件
ぞうめんわんきょく	像面湾曲
ぞうほかいていばん	増補改訂版
ぞうねんたとうるい	増粘多糖類
ぞうせつようたんし	増設用端子
ぞうけいひょうげん	造形表現
ぞうきいしょくよう	臓器移植用
ぞうきいしょくほう	臓器移植法
ぞういんようきゅう	増員要求
ぜんれっしゃつうか	全列車通過
ぜんりょくしっそう	全力疾走
ぜんりょくうんてん	全力運転
ぜんりったいこうさ	全立体交差
ぜんもじしょうきょ	全文字消去
ぜんめんひかんつう	前面非貫通
ぜんめんきんしろん	全面禁止論
ぜんめんかんつうろ	前面貫通路
ぜんめんかいしゅう	全面回収
ぜんめんうんきゅう	全面運休
ぜんぽうふちゅうい	前方不注意
ぜんぽうさんしょう	前方参照
ぜんほうそうきょく	全放送局
ぜんほういたいせい	全方位体制
ぜんぺんじょうえい	全編上映
ぜんべいだいひょう	全米代表
ぜんぶんれつそしき	前分裂組織
ぜんぶにゅうりょく	全部入力
ぜんぶしょうりゃく	全部省略
ぜんふくじこうえん	善福寺公園
ぜんびんうんきゅう	全便運休
ぜんねんどけっさん	前年度決算
ぜんにほんそうごう	全日本総合
ぜんにほんせんばつ	全日本選抜
ぜんにほんせんしゅ	全日本選手
ぜんにほんこくみん	全日本国民
ぜんにほんがくせい	全日本学生
ぜんにっぽんくうゆ	全日本空輸
ぜんにっくうしてん	全日空支店
ぜんにじゅうきかく	全二重規格
ぜんていじょうけん	前提条件
ぜんたんしょうてん	全単焦点
ぜんたいじょうほう	全体情報
ぜんたいしゅぎてき	全体主義的
ぜんたいしゅぎしゃ	全体主義者
ぜんたいしゅうごう	全体集合
ぜんたいかんりにん	全体管理人
ぜんたいかんりしゃ	全体管理者
ぜんそうこうきょり	全走行距離
ぜんせんつうかまえ	前線通過前
ぜんせんしゅさんか	全選手参加
ぜんせんきゅうこう	全線急行
ぜんせんかいぎょう	全線開業
ぜんせきじゆうせき	全席自由席
ぜんせかいたいおう	全世界対応
ぜんしょうへんすう	全称変数
ぜんしゅうこうせい	全集攻勢
ぜんしゃたいしょう	全車対象
ぜんしゃしていせき	全車指定席
ぜんさくひんちゅう	全作品中
ぜんごようこうかん	前後要交換
ぜんこくちゅうけい	全国中継
ぜんこくじゅうだん	全国縦断
ぜんこくきょうつう	全国共通
ぜんくかんきんいつ	全区間均一
ぜんきんせんじょう	漸近線上
ぜんきょくえんそう	全曲演奏
ぜんきかんゆうこう	全期間有効
ぜんがめんひょうじ	全画面表示
ぜんがくぼっしゅう	全額没収
ぜんがくだいぎいん	全学代議員
ぜんかくえいすうじ	全角英数字
ぜんかいはっぴょう	前回発表
ぜんかいちゅうもん	前回注文
ぜんかいしょうかい	前回紹介
ぜんかいこうひょう	前回好評
ぜんかいかいじょう	前回会場
ぜんえいちゅうけい	全英中継
ぜんえいだいひょう	全英代表
ぜんえいおんがっか	前衛音楽家
ぜんいんひっしゅう	全員必修
ぜんいんちゃくせき	全員着席
ぜんいんしゅうごう	全員集合
ぜんいんきょうつう	全員共通
ぜんあつちょうせい	前圧調整
ぜひごきょうりょく	是非御協力
ぜつめつしゅほぞん	絶滅種保存
ぜつめつきけんしゅ	絶滅危険種
ぜつえんたいはそん	絶縁体破損
ぜったいむせいやく	絶対無制約
ぜったいふくじゅう	絶対服従
ぜったいひょうげん	絶対表現
ぜったいのうりょく	絶対能力
ぜったいとうきゅう	絶対等級
ぜったいてきふそく	絶対的不足
ぜったいてきしんり	絶対的真理
ぜったいてきこうい	絶対的行為
ぜったいたんいけい	絶対単位系
ぜったいせいしけい	絶対静止系
ぜったいせいきすう	絶対正規数
ぜったいじょうけん	絶対条件
ぜったいじゅうよう	絶対重要
ぜったいじかんせい	絶対時間制
ぜったいしゅうそく	絶対収束
ぜったいけんりょく	絶対権力
ぜったいかせきぶん	絶対可積分
ずのうりゅうしゅつ	頭脳流出
ずけいしゅつりょく	図形出力
ずがいこつこっせつ	頭蓋骨骨折
ずいぶんれつそしき	髄分裂組織
じんるいしんかろん	人類進化論
じんるいきょうつう	人類共通
じんめんじゅうしん	人面獣心	人面獣身
じんみんりょうきん	人民料金
じんみんちゅうごく	人民中国
じんみんけんしょう	人民憲章
じんぼうちょうえき	神保町駅
じんぶんけいかもく	人文系科目
じんぶんかがくてき	人文科学的
じんぶんかがくけい	人文科学系
じんぶつちょうしょ	人物調書
じんぶつしょうごう	人物照合
じんぶつしょうかい	人物紹介
じんどうてきけんち	人道的見地
じんどうしゅぎしゃ	人道主義者
じんてきこうりゅう	人的交流
じんてきいどうめん	人的移動面
じんたいそんしょう	靭帯損傷
じんたいかいぼうず	人体解剖図
じんせいとうにょう	腎性糖尿
じんせいげきじょう	人生劇場
じんじょういちよう	尋常一様
じんじゃほんちょう	神社本庁
じんじたんとうしゃ	人事担当者
じんじきょういくぶ	人事教育部
じんしゅさべつてき	人種差別的
じんざいかいはつぶ	人材開発部
じんこうちょうせつ	人口調節
じんこうちゅうぜつ	人工中絶
じんこうぞうかりつ	人口増加率
じんこうこきゅうき	人工呼吸器
じんこうこうせつき	人工降雪機
じんこうげんしょう	人口減少
じんこうげんごてき	人工言語的
じんこうかんじょう	人工感情
じんけんひさくげん	人権費削減
じんけんそんちょう	人権尊重
じんけんじゅうりん	人権蹂躙
じんけんきょういく	人権教育
じんけんいいんかい	人権委員会
じんかくてきりえき	人格的利益
じんかくけいせいき	人格形成期
じんかいせんじゅつ	人海戦術
じりつしんけいけい	自律神経系
じょりゅうめいじん	女流名人
じょりゅうぶんがく	女流文学
じょせいりょうきん	女性料金
じょせいしんりがく	女性心理学
じょせいしんさいん	女性審査員
じょせいしゅしょう	女性首相
じょせいしゃしょう	女性車掌
じょせいさんかしゃ	女性参加者
じょせいさべつろん	女性差別論
じょせいこようしゃ	女性雇用者
じょせいがっしょう	女声合唱
じょせいうんてんし	女性運転士
じょしようちえんじ	女子幼稚園児
じょしつれいふうき	除湿冷風機	除湿冷風器
じょしだいせいやく	女子大生役
じょしだいせいむき	女子大生向
じょしせいがくいん	女子聖学院
じょししょうぎょう	女子商業
じょしこうこうせい	女子高校生
じょきょのうりょく	除去能力
じょきょうじゅどの	助教授殿
じょきょうじゅしつ	助教授室
じょうりゅうふじん	上流夫人
じょうりゅうさいと	上流サイト
じょうりゅうきぞく	上流貴族
じょうりくさくせん	上陸作戦
じょうようたいすう	常用対数
じょうようしゃよう	乗用車用
じょうようぎんこう	常陽銀行
じょうゆいしきろん	成唯識論
じょうやくかいせい	条約改正
じょうもんしきどき	縄文式土器
じょうもうでんてつ	上毛電鉄
じょうめんはっこう	上面醗酵
じょうむいんぶそく	乗務員不足
じょうほうへんかん	情報変換
じょうほうぶんるい	情報分類
じょうほうひょうじ	情報表示
じょうほうばんぐみ	情報番組
じょうほうばいたい	情報媒体
じょうほうはっしん	情報発信
じょうほうないよう	情報内容
じょうほうとうせい	情報統制
じょうほうとうごう	情報統合
じょうほうでんたつ	情報伝達
じょうほうてんそう	情報転送
じょうほうつうしん	情報通信
じょうほうちくせき	情報蓄積
じょうほうだいがく	情報大学
じょうほうたんさく	情報探索
じょうほうせんこう	情報専攻
じょうほうすうがく	情報数学
じょうほうしりょう	情報資料
じょうほうしょりか	情報処理科
じょうほうしゃだん	情報遮断
じょうほうしゃかい	情報社会
じょうほうさんらん	情報散乱
じょうほうこうぞう	情報構造
じょうほうこうがく	情報工学
じょうほうこうかん	情報交換
じょうほうこうかい	情報公開
じょうほうけんさく	情報検索
じょうほうけつらく	情報欠落
じょうほうぎじゅつ	情報技術
じょうほうがくるい	情報学類
じょうほうかんれん	情報関連
じょうほうかんけい	情報関係
じょうほうかくめい	情報革命
じょうほうかがっか	情報科学科
じょうほうかがくぶ	情報科学部
じょうほうかがくか	情報科学科
じょうほうかいせき	情報解析
じょうほうおうよう	情報応用
じょうほういんぺい	情報隠蔽
じょうばんたんだい	常磐短大
じょうばんせんない	常磐線内
じょうばんこうそく	常磐高速
じょうばんかいそく	常磐快速
じょうはつせんねつ	蒸発潜熱
じょうにんりじこく	常任理事国
じょうにんしきしゃ	常任指揮者
じょうないほうそう	場内放送
じょうないそうぜん	場内騒然
じょうどしんしゅう	浄土真宗
じょうとしょうめい	譲渡証明
じょうとしょうしょ	譲渡証書
じょうとうしゅだん	常套手段
じょうちょうぶぶん	冗長部分
じょうちゅうりょう	常駐量
じょうだんはんぶん	冗談半分
じょうだいぶんがく	上代文学
じょうたいべくとる	状態ベクトル
じょうたいへんすう	状態変数
じょうたいせんいず	状態遷移図
じょうたいくうかん	状態空間
じょうたいいってい	状態一定
じょうそうがくいん	常総学院
じょうぜんじどおり	定禅寺通	定禅寺通り
じょうせんじっけん	乗船実験
じょうすいほうしき	浄水方式
じょうすいせいのう	浄水性能
じょうじょうはいし	上場廃止
じょうじゅうふだん	常住不断
じょうじじゅうでん	常時充電
じょうしんでんてつ	上信電鉄
じょうしんえつどう	上信越道
じょうしょてんめん	情緒纏綿
じょうしょがっかい	情処学会
じょうしょうりょう	上昇量
じょうしょうちゅう	上昇中
じょうしゃほうほう	乗車方法
じょうしゃへんこう	乗車変更
じょうしゃひっすい	盛者必衰
じょうしゃにんずう	乗車人数
じょうしゃていいん	乗車定員
じょうしゃちょうさ	乗車調査
じょうしゃたいけん	乗車体験
じょうしゃせんよう	乗車専用
じょうしゃじんいん	乗車人員
じょうしゃじっせき	乗車実績
じょうしゃこうりつ	乗車効率
じょうしゃけんるい	乗車券類
じょうしきすいろん	常識推論
じょうざんかいすう	乗算回数
じょうざんえんざん	乗算演算
じょうさんめいれい	乗算命令
じょうさいだいがく	城西大学
じょうこくききゃく	上告棄却
じょうげすいしせつ	上下水施設
じょうけんへんすう	条件変数
じょうけんへんこう	条件変更
じょうけんはんだん	条件判断
じょうけんはんしゃ	条件反射
じょうけんとくべつ	条件特別
じょうけんとうそう	条件闘争
じょうけんたんさく	条件探索
じょうけんせってい	条件設定
じょうきようりょう	上記要領
じょうきょうりろん	状況理論
じょうきょうしだい	状況次第
じょうきょういぞん	状況依存
じょうきゅうしょく	上級職
じょうきゅうしかん	上級士官
じょうきゅうしかく	上級資格
じょうきぶんしょう	上記文章
じょうきじょうけん	上記条件
じょうきさんしょう	上記参照
じょうききかんない	上記期間内
じょうききかんしゃ	蒸気機関車
じょうがいらんとう	場外乱闘
じょうかのうりょく	浄化能力
じょうかさいりよう	浄化再利用
じょうえつほくせん	上越北線
じょうえつほうめん	上越方面
じょうえつなんせん	上越南線
じょうえつこくさい	上越国際
じょうえいしきもく	貞永式目
じょういごかんせい	上位互換性
じゆうれんそうほう	自由連想法
じゆうみんしゅとう	自由民主党
じゆうこくみんしゃ	自由国民社
じゆうかいほうせい	自由開放性
じゅんようせんかん	巡洋戰艦	巡洋戦艦
じゅんぷうまんぱん	順風満帆
じゅんびしほんきん	準備資本金
じゅんびかんりょう	準備完了
じゅんびいいんかい	準備委員会
じゅんひょうじゅん	準標準
じゅんにんてんのう	淳仁天皇
じゅんにゅうりょく	準入力
じゅんとくてんのう	順徳天皇
じゅんてんこうこう	順天高校
じゅんだいすうてき	純代数的
じゅんせいようひん	純正用品
じゅんせいないぞう	純正内蔵
じゅんすいすうがく	純粋数学
じゅんじょどうけい	順序同型
じゅんじょかんけい	順序関係
じゅんじょうかれん	純情可憐
じゅんしんこうこう	純心高校
じゅんしゅふかのう	遵守不可能
じゅんしゅつりょく	準出力
じゅんしていちえき	準指定地駅
じゅんしすうじかん	準指数時間
じゅんこうみさいる	巡航ミサイル
じゅんけいしきてき	準形式的
じゅんぎょうきょり	巡行距離
じゅんかんろんぽう	循環論法
じゅんかんけいとう	循環系統
じゅんかつせいのう	潤滑性能
じゅんかいむりょう	巡回無料
じゅんいはっぴょう	順位発表
じゅんあんくうこう	順安空港
じゅんあつせいぶん	順圧成分
じゅようとっしゅつ	需要突出
じゅようちょうせつ	需要調節
じゅようきょくせん	需要曲線
じゅにゅうかんかく	授乳間隔
じゅつごろんりしき	述語論理式
じゅっぱひとからげ	十把一絡
じゅっつういじょう	十通以上
じゅっちゅうはっく	十中八九
じゅちゅうせいさん	受注生産
じゅそさいばんしょ	受訴裁判所
じゅそうしんかんど	受送信感度
じゅじょうこうぞう	樹状構造
じゅしんじょうたい	受信状態
じゅしょうこうえん	授賞講演	受賞講演
じゅしょうけいけん	授賞経験
じゅこうよていしゃ	受講予定者
じゅこうしょうがい	受光障害
じゅけんべんきょう	受験勉強
じゅけんさんぎょう	受験産業
じゅけんきょかしょ	受験許可書
じゅけんきょうそう	受験競争
じゅけんきぼうしゃ	受験希望者
じゅけんかいじょう	受験会場
じゅくりょだんこう	熟慮断行
じゅくたつかかてい	熟達化過程
じゅぎょうないよう	授業内容
じゅぎょうとうろく	授業登録
じゅぎょうてんかい	授業展開
じゅえきしょうけん	受益証券
じゅえきしゃふたん	受益者負担
じゅうろくぶおんぷ	十六分音符
じゅうろくしんほう	十六進法
じゅうろくぎんこう	十六銀行
じゅうりょくりだつ	重力離脱
じゅうりょくはほう	重力波砲
じゅうりょくじょう	重力場
じゅうりょくかそく	重力加速
じゅうりょくいがい	重力以外
じゅうりょうへんか	重量変化
じゅうりょうきゅう	重量級
じゅうらいほうしき	従来方式
じゅうらいしゅほう	従来手法
じゅうらいぎじゅつ	従来技術
じゅうようるいだい	重要類題
じゅうようもんだい	重要問題
じゅうようじんぶつ	重要人物
じゅうようしりょう	重要資料
じゅうようしょるい	重要書類
じゅうようさくひん	重要作品
じゅうようこうもく	重要項目
じゅうみんとうろく	住民登録
じゅうみんそしょう	住民訴訟
じゅうみんぜいがく	住民税額
じゅうみんしゅたい	住民主体
じゅうみんうんどう	住民運動
じゅうほうでんがた	充放電型
じゅうぶんゆうこう	十分有効
じゅうぶんまんぞく	十分満足
じゅうぶんはいりょ	十分配慮
じゅうぶんつうよう	充分通用
じゅうぶんちゅうい	十分注意
じゅうぶんたいおう	充分対応
じゅうぶんしょうち	十分承知
じゅうぶんあんてい	十分安定
じゅうびょうたんい	十秒単位
じゅうばいいじょう	十倍以上
じゅうはっしりゃく	十八史略
じゅうはちぎんこう	十八銀行
じゅうねんいちじつ	十年一日
じゅうねんいじょう	十年以上
じゅうにじんしょう	十二神将
じゅうにしんしょう	十二神将
じゅうなんたいそう	柔軟体操
じゅうどしょうがい	重度障害
じゅうでんふりょう	充電不良
じゅうでんふかのう	充電不可能
じゅうでんこうりつ	充電効率
じゅうてんこうりつ	充填効率
じゅうてんこうもく	重点項目
じゅうだいもんだい	重大問題
じゅうたんばくげき	絨毯爆撃	絨緞爆撃
じゅうたくもんだい	住宅問題
じゅうたくひほじょ	住宅費補助
じゅうたくせいさく	住宅政策
じゅうたくじじょう	住宅事情
じゅうたくかいはつ	住宅開発
じゅうそうとちゅう	縦走途中
じゅうすうまんえん	十数万円
じゅうすうねんまえ	十数年前
じゅうじょうどおり	十条通り
じゅうじょうせいし	十條製紙
じゅうじにさぶんし	十字二叉分枝
じゅうしょへんこう	住所変更
じゅうしょひょうき	住所表記
じゅうしょうせいは	重賞制覇
じゅうしょうしゅぎ	重商主義
じゅうさんかいだん	十三階段
じゅうけいはんてん	重慶飯店
じゅうぐんいあんふ	従軍慰安婦
じゅうきょひょうじ	住居表示
じゅうきかんじゅう	重機関銃
じゃっかんわりだか	若干割高
じゃっかんもんだい	若干問題
じゃくれいぼうしゃ	弱冷房車
じゃくねんれいしゃ	若年齢者
じゃくねんしゃいん	若年社員
じゃくどくすいとう	弱毒水痘
じゃくちょうぼいん	弱長母音
じゃくちゅうきょう	弱中強
じゃくきょうちゅう	弱強中
じもとせつめいかい	地元説明会
じもとこうこうせい	地元高校生
じむしょうもうひん	事務消耗品
じみんとうせいけん	自民党政権
じぶんじしんいがい	自分自身以外
じはつてきせいしん	自発的精神
じはつてきこうどう	自発的行動
じはつてきうんよう	自発的運用
じどうりょうがえき	自動両替機
じどうへんそくしゃ	自動変速車
じどうふくせいきき	自動複製機器
じどうふくししせつ	児童福祉施設
じどうにゅうりょく	自動入力
じどうちゅうしゅつ	自動抽出
じどうせいせいほう	自動生成法
じどうしょうめいき	自動証明機
じどうしょうじゅう	自動小銃
じどうしょうこうき	自動昇降機
じどうしゅうりょう	自動終了
じどうしゃゆうせん	自動車優先
じどうしゃばんぐみ	自動車番組
じどうしゃとうろく	自動車登録
じどうしゃせんよう	自動車専用
じどうしゃせんしゅ	自動車選手
じどうしゃせいびし	自動車整備士
じどうしゃしゃかい	自動車社会
じどうしゃこうつう	自動車交通
じどうしゃこうがく	自動車工学
じどうしゃきぎょう	自動車企業
じどうしゃがっこう	自動車学校
じどうしゃがいしゃ	自動車会社
じどうしゃかんれん	自動車関連
じどうしゃかんけい	自動車関係
じどうさいはっしん	自動再発信
じどうけいそくよう	自動計測用
じでんてきさくひん	自伝的作品
じてんしゃりょこう	自転車旅行
じてんしゃようくつ	自転車用靴
じてんしゃほんたい	自転車本体
じてんしゃどうよう	自転車同様
じてんしゃつうきん	自転車通勤
じてんしゃつうがく	自転車通学
じつりょくぼうがい	実力妨害
じつりょくいじょう	実力以上
じつようてきばめん	実用的場面
じつようじょうげん	実用上限
じつようかどうむき	実用化動向
じつぶつだいもけい	実物大模型
じつげんようきゅう	実現要求
じつげんかのうせい	実現可能性
じつくうかんじょう	実空間上
じつぎしけんふよう	実技試験不要
じっぺんしゃいっく	十返舎一九
じっていほうじょう	実定法上
じっちきょうしゅう	実地教習
じっそうひょうげん	実装表現
じっそうしゃていぎ	実装者定義
じっそうかんにゅう	実相観入
じっそうかんきょう	実装環境
じっせんとうにゅう	実戦投入
じっせんじょしこう	実践女子高
じっせんきゅうこう	実践躬行
じっせきぜったいは	実績絶対派
じっせいかつじょう	実生活上
じっすうはっぴょう	実数発表
じっすうちょくせん	実数直線
じっすうたいじょう	実数体上
じっしゅうかいぼう	実習解剖
じっしつてきこうか	実質的効果
じっしつてきかかく	実質的価格
じっこうせんりょう	実効線量
じっこうじょうたい	実行状態
じっこうじゅんじょ	実行順序
じっこうじかいけつ	実行時解決
じっこうこんざつど	実効混雑度
じっこうかんきょう	実行環境
じっこういいんかい	実行委員会
じっけんぶつりがく	実験物理学
じっけんひけんしゃ	実験被験者
じっけんじょうけん	実験条件
じっけんしんりがく	実験心理学
じっけんざいりょう	実験材料
じっけんかがくしゃ	実験科学者
じっけんいいんかい	実験委員会
じっきょうほうそう	実況放送
じっきょうたんとう	実況担当
じっきょうけんぶん	実況見分
じっかんじゅうにし	十干十二支
じたくけんじむしょ	自宅兼事務所
じぞくかんせんしゃ	持続感染者
じじょうふあんない	事情不案内
じじょうのうりょく	自浄能力
じじょうちょうしゅ	事情聴取
じしょじゅんひかく	辞書順比較
じしょじゅんはいち	辞書順配置
じしょさいへんせい	辞書再編成
じしゅせいさくばん	自主制作版	自主製作盤
じしゃはんばいけん	自社販売権
じこぼうぎょしんり	自己防御心理
じこほぞんほんのう	自己保存本能
じこはさんしんせい	自己破産申請
じこちりょうこうい	自己治療行為
じこちゅうしんてき	自己中心的
じこぞうしょくがた	自己増殖型
じこしんこくひょう	自己申告表
じこしょうかいぶん	自己紹介文
じこしゅうせいてき	自己修正的
じこげんきゅうぶん	自己言及文
じこきょうぶんさん	自己共分散
じこがくしゅうがた	自己学習型
じげんがぞうしょり	次元画像処理
じけいれつはってん	時系列発展
じけいれつかいせき	時系列解析
じくじゅうけいげん	軸重軽減
じぎょうりょういき	事業領域
じぎょうぶかいはつ	事業部開発
じぎょうとうかつぶ	事業統轄部
じぎょうすいしんぶ	事業推進部
じぎょうかいはつぶ	事業開発部
じきしょうそうろん	時期尚早論
じききろくばいたい	磁気記録媒体
じきかこうくうけん	磁気化航空券
じかんわりもんだい	時間割問題
じかんぶんかいのう	時間分解能
じかんてきよういん	時間的要因
じかんてきぶんさん	時間的分散
じかんてきぞくせい	時間的属性
じかんちょうちかく	時間長知覚
じかんちかくきこう	時間知覚機構
じかんちえんこうか	時間遅延効果
じかんじくほうこう	時間軸方向
じかくしょうじょう	自覚症状
じえいたいしょぞく	自衛隊所属
じあえんそさんえん	次亜塩素酸塩
ざんりょうひょうじ	残量表示
ざんりょうけいこく	残量警告
ざんりゅうようせい	残留要請
ざんりゅうのうやく	残留農薬
ざんりゅうせんざい	残留洗剤
ざんていてきようそ	暫定的要素
ざんていかんりにん	暫定管理人
ざんていかいぎょう	暫定開業
ざんていいいんかい	暫定委員会
ざんだかしょうかい	残高照会
ざんぞうげんしょう	残像現象
ざんさほうていしき	残差方程式
ざんぎょうしんこく	残業申告
ざっしょくどうぶつ	雑食動物
ざっしゅきょうせい	雑種強勢
ざおうおんせんがい	蔵王温泉街
ざいりょうとくせい	材料特性
ざいりょうこうがく	材料工学
ざいりょうきょうど	材料強度
ざいりょうかいはつ	材料開発
ざいらんようぼうし	剤乱用防止
ざいらいとっきゅう	在来特急
ざいらいせんくかん	在来線区間
ざいもくざかいがん	材木座海岸
ざいていしょうにん	在廷証人
ざいたくきょういく	在宅教育
ざいせいとうゆうし	財政投融資
ざいこひんはんばい	在庫品販売
ぞうめんろこうりょう	像面露光量
ぞうせいせいびちゅう	造成整備中
ぞうけつようだいしゃ	増結用台車
ぞうきかんせんしょう	臓器感染症
ぞうかんげんぞうざい	増感現像剤
ぜんれっしゃていしゃ	全列車停車
ぜんりょくとうきゅう	全力投球
ぜんめんてきかいそう	全面的改装
ぜんぽうさんらんこう	前方散乱光
ぜんぽうこうえんふん	前方後円墳
ぜんぽうかいへいがた	前方開閉型
ぜんべいせんしゅけん	全米選手権
ぜんはんしゅうりょう	前半終了
ぜんちょうげんしょう	前兆現象
ぜんそうきょくしゅう	前奏曲集
ぜんせかいきょうつう	全世界共通
ぜんじどうせんたくき	全自動洗濯機
ぜんじくじゅうりょう	前軸重量
ぜんしょうろんりしき	全称論理式
ぜんさんぎょうちゅう	全産業中
ぜんこくれんらくかい	全国連絡会
ぜんこくてんそうけい	全国転送系
ぜんこくつうしんもう	全国通信網
ぜんこうりんかじゅう	前後輪荷重
ぜんこうだいいちごう	前項第一号
ぜんけんいにんじょう	全権委任状
ぜんきんあんていせい	漸近安定性
ぜんかくにゅうりょく	全角入力
ぜんかいそくでんしゃ	全快速電車
ぜったいてきしゃくど	絶対的尺度
ぜったいだいじょうぶ	絶対大丈夫
ぜったいくんしゅせい	絶対君主制
ぜったいあんていせい	絶対安定性
ぜいせいちょうさかい	税制調査会
ぜいかんしんこくしょ	税関申告書
ずけいひょうじかのう	図形表示可能
ずがいこつけいじょう	頭蓋骨形状
ずいはんじゅうそしき	随伴柔組織
じんみんだいかいどう	人民大会堂
じんみんきょうわこく	人民共和国
じんみんかいほうぐん	人民解放軍
じんぶんしゃかいぐん	人文社会群
じんつうゆうはつざい	陣痛誘発剤
じんつうそくしんざい	陣痛促進剤
じんぜんけっこんしき	人前結婚式
じんせいそうだんてき	人生相談的
じんしんじこぜんたい	人身事故全体
じんしゅさべつじけん	人種差別事件
じんしっかんかんじゃ	腎疾患患者
じんざいはけんぎょう	人材派遣業
じんこうよくせいさく	人口抑制策
じんこうぶつこうがく	人工物工学
じんこうせいめいたい	人工生命体
じんこうじゅうりょく	人工重力
じんこうげんじつかん	人工現実感
じんこうかんみりょう	人工甘味料
じんけんせんしんこく	人権先進国
じんぐうきゅうじょう	神宮球場
じんがいだいまきょう	人外大魔境
じんかくとくせいろん	人格特性論
じりきそうこうふのう	自力走行不能
じりきそうこうかのう	自力走行可能
じょせいろうどうしゃ	女性労働者
じょせいれいのうしゃ	女性霊能者
じょせいだいかんげい	女性大歓迎
じょせいせんようしゃ	女性専用車
じょせいしゅうかんし	女性週刊誌
じょしちゅうがくせい	女子中学生
じょがいたいしょうば	除外対象馬
じょうりゅうほうめん	上流方面
じょうりゅうしゃかい	上流社会
じょうやくかめいこく	条約加盟国
じょうやくあいてこく	条約相手国
じょうむいんくみあい	乗務員組合
じょうぼんれんだいじ	上品蓮台寺
じょうほうろんりがく	情報論理学
じょうほうりろんがく	情報理論学
じょうほうりょうきん	情報料金
じょうほうりこうがく	情報理工学
じょうほうようりょう	情報容量
じょうほうぶつりがく	情報物理学
じょうほうひょうじき	情報表示器
じょうほうひょうげん	情報表現
じょうほうにゅうしゅ	情報入手
じょうほうでんしけん	情報電子研
じょうほうていきょう	情報提供
じょうほうつうしんぶ	情報通信部
じょうほうそうりょう	情報総量
じょうほうせんりゃく	情報戦略
じょうほうすうりだい	情報数理第
じょうほうしょりほう	情報処理法
じょうほうしょりきき	情報処理機器
じょうほうしょりがく	情報処理学
じょうほうしゅうせい	上方修正
じょうほうさんぎょう	情報産業
じょうほうこうがっか	情報工学科
じょうほうこうがくぶ	情報工学部
じょうほうこうがくか	情報工学科
じょうほうけいようご	情報系用語
じょうほうけいがっか	情報系学科
じょうほうぎょうれつ	情報行列
じょうほうぎじゅつか	情報技術科
じょうほうきょうゆう	情報共有
じょうほうきょういく	情報教育
じょうほうきそかがく	情報基礎科学
じょうほうききほんぶ	情報機器本部
じょうほうかしゃかい	情報化社会
じょうほうかがくてき	情報科学的
じょうほうかがくしゃ	情報科学者
じょうほうあっしゅく	情報圧縮
じょうはんしんはだか	上半身裸
じょうはつげんしょう	蒸発現象
じょうないばくしょう	場内爆笑
じょうないはっぴょう	場内発表
じょうないねっきょう	場内熱狂
じょうちょふあんてい	情緒不安定
じょうちゅうはんてい	常駐判定
じょうちゅうかいじょ	常駐解除
じょうだいかんとうご	上代関東語
じょうたいじょうほう	状態情報
じょうたいしゅうごう	状態集合
じょうそうきょういく	情操教育
じょうすいのうりょく	浄水能力
じょうすいきたんたい	浄水器単体
じょうじょうきぎょう	上場企業
じょうじてんとうしき	常時点灯式
じょうじせいたいない	常磁性体内
じょうじきつえんしゃ	常時喫煙者
じょうしょしょうがい	情緒障害
じょうしょうけいれつ	上昇系列
じょうしょうけいこう	上昇傾向
じょうしょうきりゅう	上昇気流
じょうしょうおんけい	上昇音形
じょうしゃりょうきん	乗車料金
じょうしゃせいりけん	乗車整理券
じょうしきてきしょち	常識的処置
じょうざいせんじょう	常在戦場
じょうこうきゃくすう	乗降客数
じょうげんかかくいか	上限価格以下
じょうげせんけんよう	上下線兼用
じょうけんつきぶんぷ	条件付き分布
じょうけんえんざんし	条件演算子
じょうけいびょうしゃ	情景描写
じょうきれんらくさき	上記連絡先
じょうきょうろんてき	状況論的
じょうきょうほうこく	状況報告
じょうきょうはんだん	状況判断
じょうきょうそうてい	状況想定
じょうきょうせつめい	状況説明
じょうきょうせってい	状況設定
じょうきょうしょうこ	状況証拠	情況証拠
じょうきょうかんさつ	状況観察
じょうきょういみろん	状況意味論
じょうきゅうしんぱん	上級審判
じょうきゅうしゃよう	上級者用
じょうきゅうしゃむけ	上級者向
じょうきゅうしきかん	上級指揮官
じょうきゅうかいいん	上級会員
じょうきしょうじょう	上記症状
じょういにゅうしょう	上位入賞
じゆうらっかほうそく	自由落下法則
じゆうらっかくうかん	自由落下空間
じゆうせきしようしゃ	自由席仕様車
じゆうしゅぎじんえい	自由主義陣営
じゆうしゅぎしゃかい	自由主義社会
じゆうしゅぎけいざい	自由主義経済
じゆうさいりょうけん	自由裁量権
じゅんまいぎんじょう	純米吟醸
じゅんせいひんいがい	純製品以外
じゅんせいてきへんか	準静的変化
じゅんせいちょうりつ	純正調律
じゅんせいじょうけい	準正常系
じゅんじょひょうげん	順序表現
じゅんしょくどうしゃ	準食堂車
じゅんけっしょうせん	準決勝戦
じゅんきんちさんしゃ	準禁治産者
じゅんきゅうへんせい	準急編成
じゅんかんぜんじあい	準完全試合
じゅんかんしょうすう	循環小数
じゅんかんきゅうこう	循環急行
じゅんかいしょうにん	巡回商人
じゅめいさいばんかん	受命裁判官
じゅどうてききつえん	受動的喫煙
じゅつごけいさんけい	述語計算系
じゅっかんじゅうにし	十干十二支
じゅちょうかんきょう	受聴環境
じゅたくさいばんかん	受託裁判官
じゅしんりょうせいど	受信料制度
じゅしんじょうきょう	受信状況
じゅしんしゅうはすう	受信周波数
じゅしょうたいしょう	授賞対象
じゅこうとうろくしゃ	受講登録者
じゅこうしゃていいん	受講者定員
じゅけんさんこうしょ	受験参考書
じゅぎょうしゅっせき	授業出席
じゅうれつちゅうしゃ	縦列駐車
じゅうりょくほうこう	重力方向
じゅうりょくほうかい	重力崩壊
じゅうりょくぶっしつ	重力物質
じゅうりょくていすう	重力定数
じゅうりょくせいぎょ	重力制御
じゅうりょくこうばい	重力勾配
じゅうりょくけんない	重力圏内
じゅうりょくかそくど	重力加速度
じゅうりょうはいぶん	重量配分
じゅうりょうそくてい	重量測定
じゅうようぶんかざい	重要文化財
じゅうやくしゅっきん	重役出勤
じゅうもんじこうこう	十文字高校
じゅうみんとうひょう	住民投票
じゅうぶんじょうけん	十分条件
じゅうにしちょうがん	十二指腸癌
じゅうなんれんしょう	十何連勝
じゅうどうせいふくし	柔道整復師
じゅうどうしょうねん	柔道少年
じゅうでんでんりゅう	充電電流
じゅうでんじょうたい	充電状態
じゅうでんかんりょう	充電完了
じゅうてんりょういき	重点領域
じゅうてんけんきゅう	重点研究
じゅうだいはっぴょう	重大発表
じゅうたくじょうほう	住宅情報
じゅうたくさんぎょう	住宅産業
じゅうたくけんせつひ	住宅建設費
じゅうたいさいこうび	渋滞最後尾
じゅうたいこうさてん	渋滞交差点
じゅうそしきさいぼう	柔組織細胞
じゅうそくかのうせい	充足可能性
じゅうすいそこうせき	重水素鉱石
じゅうじしゃめんきょ	従事者免許
じゅうしょろくきのう	住所録機能
じゅうさんだいしゅう	十三代集
じゅうごうしょくばい	重合触媒
じゅうげんそこうせき	重元素鉱石
じゅうぎょういんすう	従業員数
じゅうきょかんきょう	住居環境
じゅうかくしばくだん	重核子爆弾
じゃっかんへいさてき	若干閉鎖的
じゃっかんふあんてい	若干不安定
じゃっかんえいきょう	若干影響
じゃくたいさんぎょう	弱体産業
じゃくしょうぎんこう	弱小銀行
じもとみっちゃくがた	地元密着型
じもとしょうてんがい	地元商店街
じもとさいしゅうせん	地元最終戦
じむきょくしようらん	事務局使用覧
じどうほんやくでんわ	自動翻訳電話
じどうぶんかつきのう	自動分割機能
じどうにりんめんきょ	自動二輪免許
じどうそうちゃくがた	自動装着型
じどうしゃりようしゃ	自動車利用者
じどうしゃほゆうりつ	自動車保有率
じどうしゃはいしゅつ	自動車排出
じどうしゃこうじょう	自動車工場
じどうしゃぎょうかい	自動車業界
じどうしゃきょうかい	自動車協会
じどうしゃかいたいや	自動車解体屋
じどうさくせいきのう	自動作成機能
じどうがっしょうだん	児童合唱団
じどうおうとうでんわ	自動応答電話
じどうえんそうきかい	自動演奏機械
じてんしゃぎょうかい	自転車業界
じつりょくはくちゅう	実力伯仲
じつようでんしかいろ	実用電子回路
じつようかいてんいき	実用回転域
じっちしけんめんじょ	実地試験免除
じったいけんびきょう	実体顕微鏡
じっせんりせいひはん	実践理性批判
じっせんてきぎじゅつ	実践的技術
じっせんじょがくえん	実践女学園
じっせんしょうぎょう	実践商業
じっしんぶんるいほう	十進分類法
じっしんすうひょうき	十進数表記
じっしつじぎょうしゃ	実質事業者
じっこうぞうばいりつ	k$_\{eff\}$	実効増倍率
じっこうじょうきょう	実行状況
じっこういいんちょう	実行委員長
じっけんてきしょうこ	実験的証拠
じっけんてきさくひん	実験的作品
じっけんてきこうさつ	実験的考察
じっけんおんがくてき	実験音楽的
じっきょうちゅうけい	実況中継
じっきょうしゅっぱん	実教出版
じぜんとうろくふよう	事前登録不要
じじょうだいいっこう	次条第一項
じじつじょうめんじょ	事実上免除
じじつじょうふかのう	事実上不可能
じじつじょうふかけつ	事実上不可欠
じじつじょうだったい	事実上脱退
じじつじょうかいさん	事実上解散
じしんよちじょうほう	地震予知情報
じしんよちけんきゅう	地震予知研究
じしんけんきゅうじょ	地震研究所
じしんけんきゅうしょ	地震研究所
じしんけいそくぶもん	地震計測部門
じしょとうろくきのう	辞書登録機能
じしょしきじゅんじょ	辞書式順序
じしょうさんそうえん	次硝酸蒼鉛
じしゅりゅうつうまい	自主流通米
じしゅせんたくせいど	自主選択制度
じしゅせいさくえいが	自主製作映画
じしゅじょうえいかい	自主上映会
じしゃはっちゅうしゃ	自社発注車
じこりゅうかいしゃく	自己流解釈
じこぼうえいほんのう	自己防衛本能
じこはんえいけいさん	自己反映計算
じこそしきかこうぞう	自己組織化構造
じこそうかんけいすう	自己相関係数
じこそうかんかんすう	自己相関関数
じこじゅようかんかく	自己受容感覚
じこしゅうふくきのう	自己修復機能
じこくひょうみきさい	時刻表未記載
じげんけんきゅうかい	時限研究会
じぎょうほうこくしょ	事業報告書
じぎょうぶかいはつぶ	事業部開発部
じぎょうすいしんしつ	事業推進室
じぎょうじゅんびしつ	事業準備室
じぎょうしょつうしん	事業所通信
じぎょうかすいしんぶ	事業化推進部
じぎょうかいはつしつ	事業開発室
じきふじょうてつどう	磁気浮上鉄道
じかんくうかんじょう	時間空間上
じえいしょうぼうたい	自衛消防隊
ざんていじょうきょう	暫定状況
ざんきょうおんじょう	残響音場
ざひょうにゅうりょく	座標入力
ざつぎだんげきじょう	雑技団劇場
ざつおんじょきょほう	雑音除去法
ざっしれんさいちゅう	雑誌連載中
ざっしへんしゅうしゃ	雑誌編集者
ざせきしゅうのうがた	座席収納型
ざいりょうこうがっか	材料工学科
ざいりょうこうがくぶ	材料工学部
ざいらいせんりょこう	在来線旅行
ざいらいせんのりつぎ	在来線乗継
ざいにんきかんちゅう	在任期間中
ざいにちかんこくじん	在日韓国人
ざいせいてきこんなん	財政的困難
ざいしょくしょうめい	在職証明
ぞうきょうこうじちゅう	増強工事中
ぜんれっしゃちょくつう	全列車直通
ぜんゆうきたんそりょう	全有機炭素量
ぜんめんつうこうきんし	全面通行禁止
ぜんぽうしょうがいぶつ	前方障害物
ぜんそうきょくさくひん	前奏曲作品
ぜんせんちょくりゅうか	全線直流化
ぜんきゅうこうれっしゃ	全急行列車
ぜんかもくじゅけんしゃ	全科目受験者
ぜんかくえいすうこてい	全角英数固定
ぜんかくうんどうりょう	全角運動量
ぜんかいせいせきじゅん	前回成績順
ぜんいんせいぞんちゅう	全員生存中
ぜったいとうひょうすう	絶対投票数
ぜったいてきゆういせい	絶対的優位性
ぜったいてきけんりょく	絶対的権力
ぜったいせいしくうかん	絶対静止空間
ぜったいじょうせきぶん	絶対上積分
ぜっさんほうえいちゅう	絶賛放映中
ぜっさんはつばいちゅう	絶賛発売中
ずけいへんしゅうかのう	図形編集可能
ずけいかがくきょうしつ	図形科学教室
じんせいけいけんほうふ	人生経験豊富
じんしゅさべつもんだい	人種差別問題
じんしゅさべつだんたい	人種差別団体
じんしゅかくりせいさく	人種隔離政策
じんこうとうみんそうち	人工冬眠装置
じんこうちのうぎじゅつ	人工知能技術
じんこうちのうがっかい	人工知能学会
じんこうちのうがくしゃ	人工知能学者
じんこうちのうかんけい	人工知能関係
じんこうぞうきぎじゅつ	人工臓器技術
じんこうぞうきかいはつ	人工臓器開発
じんこうせいめいかいぎ	人工生命会議
じんこうげんじつせかい	人工現実世界
じんこうかんきょうとし	人工環境都市
じんかくけいせいじょう	人格形成上
じりつぶんさんせいぎょ	自律分散制御
じょせいべっしもんだい	女性蔑視問題
じょせいとうひょうしゃ	女性投票者
じょせいじょういじだい	女性上位時代
じょせいきょうふしょう	女性恐怖症
じょせいがっしょうだん	女声合唱団
じょしびじゅつだいがく	女子美術大学
じょしじゅんけっしょう	女子準決勝
じょえんだんゆうしょう	助演男優賞
じょえんじょゆうしょう	助演女優賞
じょうれんとうこうしゃ	常連投稿者
じょうりゅうかいきゅう	上流階級
じょうようしゃてったい	乗用車撤退
じょうようかんじひょう	常用漢字表
じょうもんじだいぜんき	縄文時代前期
じょうむとりしまりやく	常務取締役
じょうみゃくちゅうしゃ	静脈注射
じょうほうりろんぶもん	情報理論部門
じょうほうふごうりろん	情報符号理論
じょうほうはっしんげん	情報発進源
じょうほうでんたつりつ	情報伝達率
じょうほうでんたつがく	情報伝達学
じょうほうてきじったい	情報的実体
じょうほうつうしんけん	情報通信研
じょうほうつうしんきき	情報通信機器
じょうほうちゅうしゅつ	情報抽出
じょうほうせんしんこく	情報先進国
じょうほうせいさんしゃ	情報生産者
じょうほうすうりがっか	情報数理学科
じょうほうじっけんしつ	情報実験室
じょうほうしょりようご	情報処理用語
じょうほうしょりぶんや	情報処理分野
じょうほうしょりしけん	情報処理試験
じょうほうしょりこうざ	情報処理講座
じょうほうしょりきのう	情報処理機能
じょうほうしょりきこう	情報処理機構
じょうほうしょりきかい	情報処理機械
じょうほうしょりかてい	情報処理過程
じょうほうしゅうしゅう	情報収集
じょうほうしゃかいがく	情報社会学
じょうほうさいぜんせん	情報最前線
じょうほうこうがくけい	情報工学系
じょうほうこうかんよう	情報交換用
じょうほうこうかんかい	情報交換会
じょうほうこうかいほう	情報公開法
じょうほうぎじゅつだい	情報技術第
じょうほうかんりしせつ	情報管理施設
じょうほうかんりがっか	情報管理学科
じょうほうかがくじてん	情報科学辞典
じょうほうかいはつしつ	情報開発室
じょうほうかいせきがく	情報解析学
じょうばんせんほうめん	常磐線方面
じょうばんせんかいそく	常磐線快速
じょうばんせんえんせん	常盤線沿線
じょうばんかいそくせん	常磐快速線
じょうのうやくもんだい	場農薬問題
じょうないだいかんせい	場内大歓声
じょうとしょうめいしょ	譲渡証明書
じょうちゅうはんていか	常駐判定可
じょうたいほうていしき	状態方程式
じょうたいせんいきそく	状態遷移規則
じょうぜんみずのごとし	上善如水
じょうせんわりびきけん	乗船割引券
じょうすいじょうせいび	浄水場整備
じょうじょさんめいれい	乗除算命令
じょうしんえつほうめん	上信越方面
じょうしきてきけつろん	常識的結論
じょうざんごうどうほう	乗算合同法
じょうこくさいばんしょ	上告裁判所
じょうこうじんいんすう	乗降人員数
じょうけんぶんききこう	条件分岐機構
じょうけんはんしゃてき	条件反射的
じょうけんつきかくりつ	条件付確率
じょうきょうびょうしゃ	状況描写
じょうきょうてきにんち	状況的認知
じょうきょういぞんせい	状況依存性
じょうがいはつばいじょ	場外発売所
じょうがいはつばいしょ	場外発売所
じょうおんかくゆうごう	常温核融合
じょうえつせんえんせん	上越線沿線
じょうえつしんかんせん	上越新幹線
じょういちゃくじゅんば	上位着順馬
じゆうぶんみゃくげんご	自由文脈言語
じゆうせききんえんしゃ	自由席禁煙車
じゆうしんしょうしゅぎ	自由心証主義
じゆうしゅうゆうくかん	自由周遊区間
じゆうけいやくせんしゅ	自由契約選手
じゅんぽうそうこうかい	遵法走行会
じゅんびいいんかいせい	準備委員会制
じゅんびいいんかいあん	準備委員会案
じゅんどうけいしゃぞう	準同形写像
じゅんてんどうだいがく	順天堂大学
じゅんぜんこくはつばい	準全国発売
じゅんせいげんぞうしょ	純正現像所
じゅんすいりせいひはん	純粋理性批判
じゅんじょかいろりろん	順序回路理論
じゅんじゅんけっしょう	準準決勝	準々決勝	凖凖決勝
じゅんしんじょがくえん	順心女学園
じゅんかんがたしゃかい	循環型社会
じゅんかいいんとうろく	準会員登録
じゅっしんぶんるいほう	十進分類法
じゅっしんすうひょうき	十進数表記
じゅちょうめいりょうど	受聴明瞭度
じゅしんけいやくりょう	受信契約料
じゅえきしゃふたんきん	受益者負担金
じゅうりょくふほうかい	重力負崩壊
じゅうりょくじょういち	重力場位置
じゅうりょうぜいかんぷ	重量税還付
じゅうようほあんぶひん	重要保安部品
じゅうようどひょうてい	重要度評定
じゅうようさんこうにん	重要参考人
じゅうぶんしようかのう	十分使用可能
じゅうねんいじょうまえ	十年以上前
じゅうねんいじょうあと	十年以上後
じゅうでんかんりょうご	充電完了後
じゅうたくほじょてあて	住宅補助手当
じゅうたくしんぽうしゃ	住宅新報社
じゅうたくこうにゅうじ	住宅購入時
じゅうたいじょうきょう	渋滞状況
じゅうじふたまたぶんし	十字二又分枝
じゅうしょうきょうそう	重賞競走	重賞競争
じゅうきょようせんざい	住居用洗剤
じゅうかがくこうぎょう	重化学工業
じゃくにくきょうしょく	弱肉強食
じゃくたいとうしゅじん	弱体投手陣
じゃくしょうせいりょく	弱小勢力
じゃくしょうさんぎょう	弱小産業
じどうはんていほうしき	自動判定方式
じどうちょうせいはんい	自動調整範囲
じどうせいぎょこうがく	自動制御工学
じどうしゃようとりょう	自動車用塗料
じどうしゃひょうろんか	自動車評論家
じどうしゃつうきんしゃ	自動車通勤者
じどうしゃせんようどう	自動車専用道
じどうしゃせんしんこく	自動車先進国
じどうしゃせいさくしょ	自動車製作所
じどうしゃしんこうかい	自動車振興会
じどうしゃしゅとくぜい	自動車取得税
じどうしゃしけんじょう	自動車試験場
じどうしゃけんさひょう	自動車検査票
じどうしゃあいこうしゃ	自動車愛好者
じてんしゃせんようどう	自転車専用道
じてんしゃせいさんしゃ	自転車生産者
じてんしゃおうだんたい	自転車横断帯
じつようてきけいさんき	実用的計算機
じつようじょうもんだい	実用上問題
じつぶつこうしょうてき	実物考証的
じつとうじょうじっせき	実搭乗実績
じつぎょうのにほんしゃ	実業之日本社
じっせんじょしがくえん	実践女子学園
じっこうてんそうそくど	実効転送速度
じっこうかんきょうよう	実行環境用
じっこうかのうけいしき	実行可能形式
じっけんてんたいぶつり	実験天体物理
じっけんてきじょうほう	実験的情報
じっけんてきけんしょう	実験的検証
じっけんしんりがくしゃ	実験心理学者
じっけんしょうせつぐん	実験小説群
じっきょうたんとうしゃ	実況担当者
じちろうこくさいきょく	自治労国際局
じぜんこうにゅうきそく	事前購入規則
じじつじょうむほしょう	事実上無保証
じしょとうろくないよう	辞書登録内容
じしょいっかつとうろく	辞書一括登録
じしゅけんぽうせいてい	自主憲法制定
じしゅうようきょうざい	自習用教材
じこちょうせつへいこう	自己調節平衡
じこそうかんぎょうれつ	自己相関行列
じけいいだいびょういん	慈恵医大病院
じくじゅうけいげんそち	軸重軽減措置
じぎょうすいしんほんぶ	事業推進本部
じぎょうかすいしんしつ	事業化推進室
じきしんがたしゃりょう	次期新型車両
じかんたんしゅくこうか	時間短縮効果
じかんじょうほうしょり	時間情報処理
じかんあっしゅくこうか	時間圧縮効果
ざんりょうけいこくとう	残量警告灯
ざんりゅうほうしゃのう	残留放射能
ざんていてきかいしゃく	暫定的解釈
ざんぞんぶんれつそしき	残存分裂組織
ざつおんよくせいこうか	雑音抑制効果
ざつおんよくあつしょり	雑音抑圧処理
ざつおんよくあつこうか	雑音抑圧効果
ざいらいせんこうそくか	在来線高速化
ざいにちちょうせんじん	在日朝鮮人
ざいにちちゅうごくじん	在日中国人
ざいけいほうていしゅぎ	罪刑法定主義
ざいがくしょうめいしょ	在学証明書
ざいがいこくにほんじん	在外国日本人
ざいがいけんきゅういん	在外研究員
ぜんめんてききょうりょく	全面的協力
ぜんめんちゅうしゃきんし	全面駐車禁止
ぜんめんえいぎょうていし	全面営業停止
ぜんはんせんさいしゅうび	前半戦最終日
ぜんにほんじつぎょうだん	全日本実業団
ぜんにっていしゅうりょう	全日程終了
ぜんせんほこうゆうりょう	全線歩行有料
ぜんせきしていとっきゅう	全席指定特急
ぜんしゃりょうしていせき	全車両指定席
ぜんこくじゅんぎょうせい	全国巡業制
ぜんこくこうせんたいこう	全国高専対抗
ぜんこくこうこうたいかい	全国高校大会
ぜんきゅうしゅうがくせい	全九州学生
ぜんかくえいすうきりかえ	全角英数切替
ぜっさんじょうえいちゅう	絶賛上映中
ぜいびきまえとうきりえき	税引前当期利益
ずいじょうぶんれつそしき	髄状分裂組織
じんこうみっしゅうちいき	人口密集地域
じんこうちのうけんきゅう	人工知能研究
じんこうずのうけんきゅう	人工頭脳研究
じょせいせんようれっしゃ	女性専用列車
じょせいせんようしんだい	女性専用寝台
じょうりょくしんようじゅ	常緑針葉樹
じょうよきんしょぶんあん	剰余金処分案
じょうほうていきょうよう	情報提供用
じょうほうていきょうしゃ	情報提供者
じょうほうつうしんかがく	情報通信科学
じょうほうちしきがっかい	情報知識学会
じょうほうしょりさぎょう	情報処理作業
じょうほうしょりがっかい	情報処理学会
じょうほうしょりがいろん	情報処理概論
じょうほうしょりかんけい	情報処理関係
じょうほうさんぎょうろん	情報産業論
じょうほうこうがくぶんや	情報工学分野
じょうほうこうがくかてい	情報工学課程
じょうほうけんきゅうじょ	情報研究所
じょうほうけんきゅうしょ	情報研究所
じょうほうけいさんぎょう	情報系産業
じょうほうぎじゅつぶんや	情報技術分野
じょうほうかくとうぎばん	情報格闘技版
じょうほうかがくせんこう	情報科学専攻
じょうほうかがくかんけい	情報科学関係
じょうほうえんしゅうしつ	情報演習室
じょうびぶんほうていしき	常微分方程式
じょうばんせんあやせえき	常磐線綾瀬駅
じょうばんじどうしゃどう	常磐自動車道
じょうちょてきよっきゅう	情緒的欲求
じょうたいせんいかんすう	状態遷移関数
じょうじょうしゃくりょう	情状酌量
じょうじかいせんせつぞく	常時回線接続
じょうしゅうきつえんしゃ	常習喫煙者
じょうしゃけんるいはいし	乗車券類廃止
じょうしきてきおんりょう	常識的音量
じょうけんぶんきめいれい	条件分岐命令
じょうきゅうりょこうしゃ	上級旅行者
じょうきゅうしゃいじょう	上級者以上
じょうきゅうさいばんしょ	上級裁判所
じょうきしゅうごうじかん	上記集合時間
じょういにゅうしょうしゃ	上位入賞者
じゆうぼうえききょうてい	自由貿易協定
じゆうせきとっきゅうけん	自由席特急券
じゆうきょうそうしじょう	自由競争市場
じゅんまいだいぎんじょう	純米大吟醸
じゅんまいぎんじょうしゅ	純米吟醸酒
じゅんびかいかんけいしゃ	準備会関係者
じゅんびいいんせんしゅつ	準備委員選出
じゅんとくじょしこうこう	潤徳女子高校
じゅんせいじょういごかん	純正上位互換
じゅんじょいそうくうかん	順序位相空間
じゅんしんじょしこうこう	純心女子高校
じゅんしんじょしがくえん	順心女子学園
じゅんきゅうていしゃえき	準急停車駅
じゅんかいいんしょうにん	準会員承認
じゅようたいきっこうざい	受容体拮抗剤
じゅたくしゅうわいようぎ	受託収賄容疑
じゅしんしゅうはすうたい	受信周波数帯
じゅぎょうりょうめんじょ	授業料免除
じゅうりょくほうていしき	重力方程式
じゅうりょくはけんしゅつ	重力波検出
じゅうりょくそうごさよう	重力相互作用
じゅうようけっていじこう	重要決定事項
じゅうみんとうろくしょう	住民登録証
じゅうぶんじつげんかのう	十分実現可能
じゅうぶんかっそうかのう	十分滑走可能
じゅうばんしょうてんがい	十番商店街
じゅうたくきんゆうこうこ	住宅金融公庫
じゅうじじょうにさぶんし	十字状二叉分枝
じゅうしょとうろくきのう	住所登録機能
じゅうしょしめいねんれい	住所氏名年齢
じゅうぎょういんはんばい	従業員販売
じゅうきょしんにゅうざい	住居侵入罪
じみんとうぶんきょうぞく	自民党文教族
じどうろしゅつちょうせい	自動露出調整
じどうがくしゅうしすてむ	自動学習システム
じつりょくはんていしけん	実力判定試験
じっこうかんきょうじょう	実行環境上
じっこうかのうじょうたい	実行可能状態
じこくひょうふっこくばん	時刻表復刻版
じかんちょうちかくきこう	時間長知覚機構
じぇいあーるひがしにほん	JR東日本
ざつおんよくせいしゅほう	雑音抑制手法
ざつおんよくあつしゅほう	雑音抑圧手法
ざっしへんしゅうがいしゃ	雑誌編集会社
ざいりょうけんきゅうしつ	材料研究室
ざいりゅうきょりゅうみん	在留居留民
ざいせいてきじょうきょう	財政的状況
ぜんふくじじょうすいじょう	善福寺浄水場
ぜんじんかくてききょういく	全人格的教育
ぜんがくだいひょうしゃかい	全学代表者会
じんこうにんしんちゅうぜつ	人工妊娠中絶
じんこうとうせきりょうほう	人工透析療法
じんこうせいめいけんきゅう	人工生命研究
じんこうしんけいかいろもう	人工神経回路網
じょせいせんようしゃりょう	女性専用車両
じょうほうろんりがくこうざ	情報論理学講座
じょうほうていきょうしせつ	情報提供施設
じょうほうしょりのうりょく	情報処理能力
じょうほうしょりけんきゅう	情報処理研究
じょうほうしょりきょういく	情報処理教育
じょうほうしょりえんしゅう	情報処理演習
じょうほうこうがくじっけん	情報工学実験
じょうほうぎじゅつかいはつ	情報技術開発
じょうほうかがくきょうしつ	情報科学教室
じょうほうかがくきょうかい	情報科学協会
じょうほうかがくいいんかい	情報科学委員会
じょうほうかいせきぎじゅつ	情報解析技術
じょうちゅうはんていふのう	常駐判定不能
じょうたいすうさいしょうか	状態数最小化
じょうたいけんしゅつふのう	状態検出不能
じょうしんでんてつえんせん	上信電鉄沿線
じょうしゃれっしゃばんごう	乗車列車番号
じょうしゃていいんへんこう	乗車定員変更
じゅんだんせいこうさんらん	準弾性光散乱
じゅんすいだんじょこうゆう	純粋男女交遊
じゅんえいぎょうじょうたい	準営業状態
じゅうりょくけんきゅうじょ	重力研究所
じゅうようむけいぶんかざい	重要無形文化財
じゅうみんきほんだいちょう	住民基本台帳
じゅうじしゃめんきょしょう	従事者免許証
じゅうきょふほうしんにゅう	住居不法侵入
じゅうきょひょうじばんごう	住居表示番号
じみんぞくちゅうしんしゅぎ	自民族中心主義
じどうしゃきょうしゅうじょ	自動車教習所
じちょうたんしげんさいぼう	次頂端始原細胞
じしんぜんちょうげんしょう	地震前兆現象
じしゅうえんしげんさいぼう	次周縁始原細胞
じくほうこうじゅうさいぼう	軸方向柔細胞
じくしゅつりょくきょくせん	軸出力曲線
じぎょうきょうどうくみあい	事業協同組合
ざいらいせんがたとっきゅう	在来線型特急
ぜんせんしゅにゅうじょうしき	全選手入場式
ぜんかくくうはくにゅうりょく	全角空白入力
ぜったいてききゅうきょくせい	絶対的究極性
ずひょうばんごうしゅつりょく	図表番号出力
じんこうちのうけんきゅうしつ	人工知能研究室
じょうりょくこうようじゅりん	常緑広葉樹林
じょうほうにゅうしゅけいたい	情報入手形態
じょうほうでんたつのうりょく	情報伝達能力
じょうほうていきょうけいたい	情報提供形態
じょうほうていきょうがいしゃ	情報提供会社
じょうほうつうしんけんきゅう	情報通信研究
じょうほうしょりぎじゅつしゃ	情報処理技術者
じょうほうこうぞうけんきゅう	情報構造研究
じょうほうこうがくきょうしつ	情報工学教室
じょうほうかがくけんきゅうか	情報科学研究科
じょうばんこうぎょうかいかん	常磐工業会館
じょうたいせんいまとりっくす	状態遷移マトリックス
じゅうりょくはぼうえんきょう	重力波望遠鏡
じゅうじじょうふたまたぶんし	十字状二又分枝
じゃくねんせいろうじんびょう	若年性老人病
じつげんかのうせいかいしゃく	実現可能性解釈
じっせんしょうぎょうこうこう	実践商業高校
じっこうせんりょうとうりょう	実効線量当量
じりつしんけいしっちょうしょう	自律神経失調症
じょしさべつてっぱいじょうやく	女子差別撤廃条約
じょうほうしゅうしゅうかつどう	情報収集活動
じょうほうこうがくけんきゅうか	情報工学研究科
じょうほうかんきょうきょうかい	情報環境協会
じょうほうおうようけんきゅうぶ	情報応用研究部
じゅんていじょうしょうげきおん	準定常衝撃音
じゅうてんりょういきちょうしょ	重点領域調書
じゅうてんりょういきけんきゅう	重点領域研究
じゅうぎょういんもちかぶせいど	従業員持株制度
じょせいさべつてっぱいじょうやく	女性差別撤廃条約
じょうほうしゅうしゅうのうりょく	情報収拾能力
じょうほうひょうじゅんしゅつりょく	情報標準出力
じゅうしょうきゅうせいこきゅうきしょうこうぐん	重症急性呼吸器症候群
